state,county,rep2008,dem2008,other2008,turnout2008,rep2012,dem2012,other2012,turnout2012,pop,dem_margin08,dem_margin12,winner08,winner12,pop_decile
alabama,shelby,68945,20575,0,89520,71243,19944,1017,92204,187880,-0.5403261840929401,-0.5625692258764956,Rep (McCain),Rep (Romney),9
alabama,choctaw,4220,3633,0,7853,4150,3785,30,7965,14111,-0.07474850375652617,-0.045998739760554505,Rep (McCain),Rep (Romney),4
alabama,lee,32344,21410,0,53754,32062,21274,779,54115,135010,-0.20340811846560256,-0.2022648867556622,Rep (McCain),Rep (Romney),9
alabama,tallapoosa,13105,6052,0,19157,12303,6252,113,18668,41534,-0.36816829357415043,-0.32611156022635407,Rep (McCain),Rep (Romney),7
alabama,marion,9530,2597,0,12127,9696,2249,159,12104,30792,-0.5716995134823122,-0.623440770196735,Rep (McCain),Rep (Romney),6
alabama,lowndes,1807,5447,0,7254,1754,5747,18,7519,11731,0.5017921146953405,0.5323290227969604,Dem (Obama),Dem (Obama),3
alabama,greene,876,4402,0,5278,799,4514,15,5328,9255,0.6680560818491853,0.6992283079239601,Dem (Obama),Dem (Obama),2
alabama,elmore,25695,8268,0,33963,26223,8940,277,35440,77650,-0.5131172157936578,-0.4915109632283935,Rep (McCain),Rep (Romney),8
alabama,butler,5472,4174,0,9646,5081,4367,35,9483,20895,-0.13456354965788928,-0.07557154953429297,Rep (McCain),Rep (Romney),5
alabama,bullock,1389,4001,0,5390,1250,4058,10,5318,10923,0.48460111317254173,0.5290128108515448,Dem (Obama),Dem (Obama),3
alabama,pike,7981,5856,0,13837,7939,6009,109,14057,32147,-0.15357375153573752,-0.1383710926297677,Rep (McCain),Rep (Romney),6
alabama,marengo,5511,5925,0,11436,5321,6154,34,11509,21296,0.03620146904512067,0.0725925925925926,Dem (Obama),Dem (Obama),5
alabama,crenshaw,4316,1938,0,6254,4326,2048,37,6411,13928,-0.3802366485449312,-0.35738939441481016,Rep (McCain),Rep (Romney),4
alabama,chilton,13934,3666,0,17600,13910,3391,133,17434,43121,-0.5834090909090909,-0.6079995375989827,Rep (McCain),Rep (Romney),7
alabama,cleburne,5204,1166,0,6370,5269,971,62,6302,14823,-0.6339089481946625,-0.6887820512820513,Rep (McCain),Rep (Romney),4
alabama,calhoun,32326,16325,0,48651,30272,15500,468,46240,117149,-0.3288935479229615,-0.32273005330769905,Rep (McCain),Rep (Romney),9
alabama,russell,8700,10078,0,18778,8276,10495,100,18871,51663,0.07338374693790606,0.11821426668797613,Dem (Obama),Dem (Obama),7
alabama,pickens,5426,4584,0,10010,5119,4448,32,9599,19917,-0.08411588411588411,-0.07013692902686318,Rep (McCain),Rep (Romney),5
alabama,dallas,6791,13958,0,20749,6284,14599,53,20936,44066,0.3454142368306906,0.3981707609060001,Dem (Obama),Dem (Obama),7
alabama,covington,12431,3238,0,15669,12148,3155,112,15415,37608,-0.5866998532133512,-0.5876625498268313,Rep (McCain),Rep (Romney),7
alabama,tuscaloosa,45351,32738,0,78089,45703,32003,789,78495,188331,-0.16152082879791008,-0.1763055619900651,Rep (McCain),Rep (Romney),9
alabama,marshall,25680,7021,0,32701,25785,6271,399,32455,90867,-0.5705941714320663,-0.6087471924132768,Rep (McCain),Rep (Romney),9
alabama,macon,1396,9444,0,10840,1322,9045,18,10385,21699,0.7424354243542436,0.7449599691328254,Dem (Obama),Dem (Obama),5
alabama,clay,4946,1722,0,6668,4802,1770,68,6640,14040,-0.483503299340132,-0.4613511868533171,Rep (McCain),Rep (Romney),4
alabama,wilcox,1849,4553,0,6402,1676,4867,4,6547,12012,0.42236800999687596,0.4876967751795812,Dem (Obama),Dem (Obama),3
alabama,randolph,7169,3062,0,10231,7219,3076,96,10391,22817,-0.4014270354804027,-0.4024283632831472,Rep (McCain),Rep (Romney),5
alabama,dekalb,17951,5654,0,23605,18316,5235,291,23842,70038,-0.52094895149332765,-0.5554328903231285,Rep (McCain),Rep (Romney),8
alabama,conecuh,3461,3411,0,6872,3434,3551,28,7013,13382,-0.007275902211874272,0.016750178954903366,Rep (McCain),Dem (Obama),3
alabama,mobile,97670,81741,0,179411,94566,78417,1206,174189,408620,-0.08878496859166941,-0.09335599451969269,Rep (McCain),Rep (Romney),10
alabama,houston,29205,12194,0,41399,29214,12348,281,41843,99029,-0.4109036450155801,-0.4058033780857514,Rep (McCain),Rep (Romney),9
alabama,henry,5558,2990,0,8548,5605,3046,49,8700,17148,-0.300421151146467,-0.2958039533001965,Rep (McCain),Rep (Romney),4
alabama,cherokee,7285,2299,0,9584,7494,2126,141,9761,25700,-0.5202420701168614,-0.558004158004158,Rep (McCain),Rep (Romney),5
alabama,blount,20362,3518,0,23880,20741,2961,278,23980,56692,-0.7053601340033501,-0.7501476668635558,Rep (McCain),Rep (Romney),8
alabama,jackson,14068,6367,0,20435,14422,5817,316,20555,53386,-0.37685343772938584,-0.42516922772864274,Rep (McCain),Rep (Romney),8
alabama,escambia,9365,5176,0,14541,9263,5476,93,14832,37996,-0.2880819751048759,-0.25693737702693537,Rep (McCain),Rep (Romney),7
alabama,bibb,6247,2289,0,8536,6131,2200,60,8391,22610,-0.46368322399250234,-0.4718521185932061,Rep (McCain),Rep (Romney),5
alabama,winston,8099,1756,0,9855,8310,1286,116,9712,24687,-0.64363267376966,-0.7319716548561901,Rep (McCain),Rep (Romney),5
alabama,washington,5592,3032,0,8624,5749,2971,41,8761,17556,-0.29684601113172543,-0.31857798165137613,Rep (McCain),Rep (Romney),4
alabama,hale,3196,4969,0,8165,3205,5401,22,8628,16168,0.21714635639926516,0.25517081106204975,Dem (Obama),Dem (Obama),4
alabama,sumter,1723,5218,0,6941,1585,5420,20,7025,13871,0.5035297507563752,0.5474660956459672,Dem (Obama),Dem (Obama),4
alabama,monroe,6173,5023,0,11196,5730,4897,53,10680,23329,-0.10271525544837443,-0.07838524513032841,Rep (McCain),Rep (Romney),5
alabama,colbert,14729,9698,0,24427,13931,9160,283,23374,54446,-0.20596061734965407,-0.20661729678229612,Rep (McCain),Rep (Romney),8
alabama,jefferson,149843,166015,0,315858,141413,159658,2353,303424,656912,0.0512002228849673,0.06060032351172979,Dem (Obama),Dem (Obama),10
alabama,talladega,20109,13769,0,33878,19217,13878,222,33317,82347,-0.18714209811677196,-0.1613234627587249,Rep (McCain),Rep (Romney),8
alabama,autauga,17398,6091,0,23489,17366,6354,189,23909,53155,-0.4813742602920516,-0.4642495784148398,Rep (McCain),Rep (Romney),8
alabama,cullman,27699,5601,0,33300,27930,4855,393,33178,79941,-0.6636036036036036,-0.7038279701082812,Rep (McCain),Rep (Romney),8
alabama,barbour,5862,5685,0,11547,5539,5873,47,11459,27699,-0.01532865679397246,0.029267437784787943,Rep (McCain),Dem (Obama),6
alabama,morgan,35986,13882,0,49868,35309,13401,488,49198,117632,-0.44325018047645787,-0.44976390884828576,Rep (McCain),Rep (Romney),9
alabama,coosa,3245,2269,0,5514,3028,2188,27,5243,11470,-0.17700398984403337,-0.16104294478527606,Rep (McCain),Rep (Romney),3
alabama,limestone,23588,9530,0,33118,25263,9809,334,35406,78614,-0.4244821547194879,-0.44063640510948904,Rep (McCain),Rep (Romney),8
alabama,lauderdale,24050,13318,0,37368,23902,12504,502,36908,91762,-0.287197602226504,-0.3130802614953579,Rep (McCain),Rep (Romney),9
alabama,stclair,27630,6088,0,33718,29001,5790,314,35105,80658,-0.638887241236135,-0.6671552987841683,Rep (McCain),Rep (Romney),8
alabama,fayette,5875,1988,0,7863,6034,1803,75,7912,17472,-0.4943405824748824,-0.5398749521500574,Rep (McCain),Rep (Romney),4
alabama,coffee,14909,5068,0,19977,14638,4899,178,19715,48349,-0.49261650898533316,-0.49849004453089013,Rep (McCain),Rep (Romney),7
alabama,clarke,7455,5907,0,13362,7463,6317,47,13827,26255,-0.11585092052088011,-0.08316400580551524,Rep (McCain),Rep (Romney),6
alabama,etowah,30562,13480,0,44042,29102,12792,596,42490,104066,-0.387857045547432,-0.38931589249057147,Rep (McCain),Rep (Romney),9
alabama,dale,13873,5257,0,19130,13105,5283,163,18551,49730,-0.45039205436487195,-0.425386121383511,Rep (McCain),Rep (Romney),7
alabama,madison,86910,64062,0,150972,90679,61802,2151,154632,323080,-0.15133932119863286,-0.18938097205553478,Rep (McCain),Rep (Romney),10
alabama,baldwin,61192,19362,0,80554,65772,18329,887,84988,175791,-0.5192789929736574,-0.5641193327071021,Rep (McCain),Rep (Romney),9
alabama,montgomery,41972,61999,0,103971,38283,62993,505,101781,228018,0.19262101932269576,0.24398672933370197,Dem (Obama),Dem (Obama),10
alabama,franklin,8048,3469,0,11517,7567,3171,121,10859,31383,-0.39758617695580445,-0.409387222946545,Rep (McCain),Rep (Romney),6
alabama,walker,20719,7418,0,28137,21633,6551,313,28497,67612,-0.47272274940469844,-0.5351263128015895,Rep (McCain),Rep (Romney),8
alabama,perry,1676,4423,0,6099,1504,4536,25,6065,10684,0.4504017051975734,0.5019867549668874,Dem (Obama),Dem (Obama),3
alabama,geneva,9314,2106,0,11420,9173,2039,106,11318,26541,-0.6311733800350263,-0.6362825544059936,Rep (McCain),Rep (Romney),6
alabama,lawrence,9269,5159,0,14428,8855,5055,169,14079,34235,-0.2848627668422512,-0.2731847591660676,Rep (McCain),Rep (Romney),6
alabama,lamar,5419,1614,0,7033,5453,1643,63,7159,14743,-0.5410209014645244,-0.5369222096956031,Rep (McCain),Rep (Romney),4
alabama,chambers,8060,6782,0,14842,7596,6853,113,14562,34579,-0.08610699366662175,-0.051422243753893,Rep (McCain),Rep (Romney),6
arizona,yavapai,54574,32667,0,87241,62385,32624,1781,96790,209260,-0.2511089969165874,-0.31324400846235617,Rep (McCain),Rep (Romney),10
arizona,graham,8140,3381,0,11521,8076,3609,170,11855,36030,-0.41307178196337124,-0.3822849807445443,Rep (McCain),Rep (Romney),6
arizona,cochise,25005,15752,0,40757,28197,17377,873,46447,129268,-0.22702848590426183,-0.2374160705665511,Rep (McCain),Rep (Romney),9
arizona,pima,146876,166095,0,312971,165237,186456,5530,357223,964462,0.06140824549239386,0.06033387073385026,Dem (Obama),Dem (Obama),10
arizona,gila,12886,7298,0,20184,12846,7293,348,20487,53272,-0.27685295283392786,-0.27573365112468345,Rep (McCain),Rep (Romney),8
arizona,coconino,19449,27064,0,46513,19720,26772,1089,47581,131824,0.1637176703287253,0.15168200980813903,Dem (Obama),Dem (Obama),9
arizona,navajo,18119,14453,0,32572,19880,16945,498,37323,107060,-0.11255065700601743,-0.07970128988458927,Rep (McCain),Rep (Romney),9
arizona,pinal,55086,40957,0,96043,58947,41428,1764,102139,329297,-0.1471111897795779,-0.17453549190535492,Rep (McCain),Rep (Romney),10
arizona,apache,7844,14434,0,22278,8250,17147,442,25839,70312,0.2958075231169764,0.3503169665708548,Dem (Obama),Dem (Obama),8
arizona,mohave,39447,19953,0,59400,47901,18991,1233,68125,199177,-0.3281818181818182,-0.4321892005023022,Rep (McCain),Rep (Romney),10
arizona,maricopa,596611,483358,0,1079969,680089,532284,21098,1233471,3751410,-0.10486689895728489,-0.12191380045580032,Rep (McCain),Rep (Romney),10
arizona,greenlee,1711,1165,0,2876,1590,1310,72,2972,8318,-0.1898470097357441,-0.09655172413793103,Rep (McCain),Rep (Romney),2
arizona,yuma,19311,14538,0,33849,22493,17328,497,40318,190526,-0.14100859700434282,-0.12970543180733785,Rep (McCain),Rep (Romney),9
arizona,santacruz,4517,8680,0,13197,4235,9486,173,13894,46051,0.3154504811699629,0.38269805407769114,Dem (Obama),Dem (Obama),7
arizona,lapaz,3302,1794,0,5096,3205,1619,98,4922,20549,-0.29591836734693877,-0.32877280265339964,Rep (McCain),Rep (Romney),5
arkansas,sevier,3052,1254,0,4306,3135,1042,151,4328,16636,-0.4175568973525314,-0.5010773282259995,Rep (McCain),Rep (Romney),4
arkansas,cleveland,2443,909,0,3352,2307,844,108,3259,8769,-0.45763723150357993,-0.46429704855601395,Rep (McCain),Rep (Romney),2
arkansas,baxter,12841,6531,0,19372,13688,5172,479,19339,41388,-0.3257278546355565,-0.45153764581124073,Rep (McCain),Rep (Romney),7
arkansas,scott,2790,1052,0,3842,2630,895,112,3637,11226,-0.4523685580426861,-0.4921985815602837,Rep (McCain),Rep (Romney),3
arkansas,woodruff,1135,1350,0,2485,1227,1340,118,2685,7505,0.08651911468812877,0.044020257109466304,Dem (Obama),Dem (Obama),2
arkansas,polk,5470,1955,0,7425,5950,1556,215,7721,20490,-0.4734006734006734,-0.5853983479882761,Rep (McCain),Rep (Romney),5
arkansas,crawford,14746,5265,0,20011,15125,4872,565,20562,60778,-0.4737894158212983,-0.5127269090363554,Rep (McCain),Rep (Romney),8
arkansas,stfrancis,3910,5371,0,9281,3287,4652,82,8021,28302,0.15741838163990948,0.17193601209220305,Dem (Obama),Dem (Obama),6
arkansas,boone,10559,4429,0,14988,11143,3762,458,15363,36710,-0.4089938617560715,-0.4952029520295203,Rep (McCain),Rep (Romney),7
arkansas,prairie,2223,1048,0,3271,2149,877,108,3134,8839,-0.35921736472026905,-0.4203569068076669,Rep (McCain),Rep (Romney),2
arkansas,lee,1455,2263,0,3718,1280,2107,37,3424,10709,0.21732114039806347,0.24416888101564807,Dem (Obama),Dem (Obama),3
arkansas,marion,4510,2379,0,6889,4771,2024,234,7029,16779,-0.30933372042386414,-0.40426784400294336,Rep (McCain),Rep (Romney),4
arkansas,independence,8023,3551,0,11574,8724,3279,387,12390,35994,-0.38638327285294627,-0.4536365908522869,Rep (McCain),Rep (Romney),6
arkansas,greene,8578,4541,0,13119,9066,3998,690,13754,41318,-0.30772162512386614,-0.38793631353337416,Rep (McCain),Rep (Romney),7
arkansas,cross,4393,2580,0,6973,4268,2279,133,6680,18144,-0.2600028682059372,-0.3038032686726745,Rep (McCain),Rep (Romney),4
arkansas,mississippi,6967,6638,0,13605,6599,6445,305,13349,46815,-0.02418228592429254,-0.011806194418889911,Rep (McCain),Rep (Romney),7
arkansas,crittenden,7420,9361,0,16781,6192,9092,229,15513,50673,0.11566652762052321,0.18974090552211462,Dem (Obama),Dem (Obama),7
arkansas,pike,2727,1087,0,3814,2847,850,90,3787,11286,-0.4299947561615102,-0.5401677035434136,Rep (McCain),Rep (Romney),3
arkansas,pope,16050,6226,0,22276,14733,5108,549,20390,60460,-0.4410127491470641,-0.48510659744972534,Rep (McCain),Rep (Romney),8
arkansas,phillips,3094,5687,0,8781,2591,5179,130,7900,22412,0.2952966632501993,0.3330759330759331,Dem (Obama),Dem (Obama),5
arkansas,howard,2956,1745,0,4701,2862,1460,97,4419,13778,-0.257604764943629,-0.3243868579361407,Rep (McCain),Rep (Romney),3
arkansas,yell,3805,2001,0,5806,4041,1720,210,5971,21895,-0.3107130554598691,-0.40288144419371635,Rep (McCain),Rep (Romney),5
arkansas,hotspring,7014,4216,0,11230,7087,3824,328,11239,32671,-0.24915405164737311,-0.29905599853358994,Rep (McCain),Rep (Romney),6
arkansas,grant,5022,1562,0,6584,4829,1467,182,6478,17657,-0.5255164034021871,-0.533989834815756,Rep (McCain),Rep (Romney),4
arkansas,columbia,5711,3496,0,9207,5790,3557,108,9455,24756,-0.24057782122298252,-0.23890018187653791,Rep (McCain),Rep (Romney),5
arkansas,cleburne,7962,2951,0,10913,8691,2618,334,11643,25692,-0.45917712819572987,-0.5370059244849235,Rep (McCain),Rep (Romney),5
arkansas,vanburen,4269,2145,0,6414,4362,1826,233,6421,17237,-0.33115060804490176,-0.40982546864899805,Rep (McCain),Rep (Romney),4
arkansas,calhoun,1459,690,0,2149,1458,660,56,2174,5529,-0.3578408562121917,-0.37677053824362605,Rep (McCain),Rep (Romney),2
arkansas,bradley,2259,1673,0,3932,2118,1447,69,3634,11638,-0.14903357070193285,-0.188218793828892,Rep (McCain),Rep (Romney),3
arkansas,faulkner,25310,14099,0,39409,26653,13559,1110,41322,108375,-0.2844781648861935,-0.3256241917835472,Rep (McCain),Rep (Romney),9
arkansas,dallas,1756,1470,0,3226,1664,1337,82,3083,8280,-0.08865468071915684,-0.10896367877374209,Rep (McCain),Rep (Romney),2
arkansas,sebastian,28404,13592,0,41996,29158,13083,1099,43340,123847,-0.35270025716734926,-0.38055443763168484,Rep (McCain),Rep (Romney),9
arkansas,drew,3860,2598,0,6458,3883,2627,116,6626,18546,-0.19541653762774852,-0.19293394777265746,Rep (McCain),Rep (Romney),4
arkansas,desha,1977,2546,0,4523,1807,2353,80,4240,13351,0.12580145920848995,0.13125,Dem (Obama),Dem (Obama),3
arkansas,clay,3032,2245,0,5277,3225,1738,147,5110,16297,-0.1491377676710252,-0.2996171670360669,Rep (McCain),Rep (Romney),4
arkansas,carroll,6070,4160,0,10230,6121,3691,360,10172,26971,-0.18670576735092864,-0.24765593151243376,Rep (McCain),Rep (Romney),6
arkansas,randolph,3601,2460,0,6061,3699,2040,209,5948,18049,-0.18825276357036794,-0.28907475169890223,Rep (McCain),Rep (Romney),4
arkansas,searcy,2726,1161,0,3887,2699,814,181,3694,8227,-0.4026241317211217,-0.5365784230002847,Rep (McCain),Rep (Romney),2
arkansas,logan,5136,2196,0,7332,5078,2009,243,7330,22580,-0.40098199672667756,-0.4330464230280796,Rep (McCain),Rep (Romney),5
arkansas,nevada,2061,1471,0,3532,1996,1314,74,3384,9149,-0.16704416761041901,-0.20604229607250754,Rep (McCain),Rep (Romney),2
arkansas,jackson,3146,2220,0,5366,3065,2093,180,5338,18015,-0.17256802087215803,-0.18844513377278016,Rep (McCain),Rep (Romney),4
arkansas,washington,37915,28965,0,66880,39570,28136,2525,70231,197192,-0.13382177033492823,-0.16887720438365875,Rep (McCain),Rep (Romney),10
arkansas,stone,3810,1756,0,5566,3773,1356,222,5351,12321,-0.36902623068630974,-0.47124195749658804,Rep (McCain),Rep (Romney),3
arkansas,miller,9913,4866,0,14779,10619,4517,189,15325,43048,-0.34149807158806417,-0.4031448202959831,Rep (McCain),Rep (Romney),7
arkansas,monroe,1602,1505,0,3107,1585,1583,62,3230,8492,-0.031219826198905697,-6.313131313131314e-4,Rep (McCain),Rep (Romney),2
arkansas,poinsett,4900,2740,0,7640,4967,2387,196,7550,24703,-0.28272251308900526,-0.3508294805548001,Rep (McCain),Rep (Romney),5
arkansas,lonoke,17046,5880,0,22926,17450,5237,585,23272,65846,-0.4870452761057315,-0.5383259135187553,Rep (McCain),Rep (Romney),8
arkansas,jefferson,10614,18272,0,28886,9515,17456,393,27364,78447,0.2651111264972651,0.2944273478921805,Dem (Obama),Dem (Obama),8
arkansas,benton,50855,23412,0,74267,48649,20267,1712,70628,209911,-0.36951809013424536,-0.4118346973126705,Rep (McCain),Rep (Romney),10
arkansas,lafayette,1685,1133,0,2818,1712,1173,43,2928,7764,-0.19588360539389638,-0.18682842287694973,Rep (McCain),Rep (Romney),2
arkansas,conway,4687,3144,0,7831,4511,3003,210,7724,21059,-0.197037415400332,-0.20069204152249134,Rep (McCain),Rep (Romney),5
arkansas,saline,30842,12657,0,43499,32962,12868,1229,47059,102439,-0.4180555874847698,-0.43844643246781584,Rep (McCain),Rep (Romney),9
arkansas,izard,3141,1767,0,4908,3571,1563,179,5313,13636,-0.27995110024449876,-0.39111803661862093,Rep (McCain),Rep (Romney),3
arkansas,fulton,2700,1818,0,4518,2949,1452,121,4522,12263,-0.1952191235059761,-0.3401499659168371,Rep (McCain),Rep (Romney),3
arkansas,pulaski,70094,88632,0,158726,68856,87055,3144,159055,377060,0.11679245996245102,0.11672685057500753,Dem (Obama),Dem (Obama),10
arkansas,hempstead,4252,2861,0,7113,4284,2466,169,6919,22747,-0.19555743005764095,-0.2693333333333333,Rep (McCain),Rep (Romney),5
arkansas,littleriver,3247,1752,0,4999,3385,1552,114,5051,13145,-0.29905981196239245,-0.3712781041118088,Rep (McCain),Rep (Romney),3
arkansas,sharp,4535,2436,0,6971,4920,2092,270,7282,17432,-0.30110457610098984,-0.4033086138049059,Rep (McCain),Rep (Romney),4
arkansas,johnson,4911,3043,0,7954,5045,2785,234,8064,25180,-0.2348503897410108,-0.2886334610472541,Rep (McCain),Rep (Romney),5
arkansas,craighead,18859,11279,0,30138,20044,10351,812,31207,93329,-0.25150972194571636,-0.31890113505510775,Rep (McCain),Rep (Romney),9
arkansas,ashley,5166,2883,0,8049,4866,2855,194,7915,22126,-0.2836377189713008,-0.2604584898329232,Rep (McCain),Rep (Romney),5
arkansas,arkansas,4184,2616,0,6800,3892,2454,142,6488,19321,-0.23058823529411765,-0.22659943271352032,Rep (McCain),Rep (Romney),5
arkansas,ouachita,5602,4598,0,10200,5516,4626,161,10303,26293,-0.09843137254901961,-0.08775389469532636,Rep (McCain),Rep (Romney),6
arkansas,madison,3970,2142,0,6112,4262,2099,206,6567,15507,-0.29908376963350786,-0.3400408740764031,Rep (McCain),Rep (Romney),4
arkansas,garland,25011,14987,0,39998,25031,13317,893,39241,95290,-0.2506125306265313,-0.3054657348492751,Rep (McCain),Rep (Romney),9
arkansas,montgomery,2359,1090,0,3449,2368,920,115,3403,9490,-0.36793273412583355,-0.44038929440389296,Rep (McCain),Rep (Romney),3
arkansas,franklin,4407,1868,0,6275,4631,1725,183,6539,18176,-0.40462151394422313,-0.4572057898049087,Rep (McCain),Rep (Romney),4
arkansas,perry,2743,1351,0,4094,2580,1187,170,3937,10435,-0.340009770395701,-0.36979028404565967,Rep (McCain),Rep (Romney),3
arkansas,union,10657,6177,0,16834,10696,6182,282,17160,42180,-0.2661280741356778,-0.26744874985187816,Rep (McCain),Rep (Romney),7
arkansas,lincoln,2513,1709,0,4222,2199,1424,102,3725,14203,-0.19043107531975367,-0.21391112337841567,Rep (McCain),Rep (Romney),4
arkansas,chicot,1935,2927,0,4862,1670,2649,42,4361,12102,0.20403126285479226,0.22667284093540171,Dem (Obama),Dem (Obama),3
arkansas,white,19429,6708,0,26137,20005,5765,738,26508,74957,-0.4867046715384321,-0.5525805199844781,Rep (McCain),Rep (Romney),8
arkansas,newton,1716,740,0,2456,2508,993,160,3661,8394,-0.3973941368078176,-0.43273350471293914,Rep (McCain),Rep (Romney),2
arkansas,lawrence,3357,2136,0,5493,3535,1786,216,5537,17340,-0.2222829055161114,-0.32869761323059576,Rep (McCain),Rep (Romney),4
arkansas,clark,4608,4265,0,8873,4343,3808,255,8406,23083,-0.038656598670122846,-0.06563611826769722,Rep (McCain),Rep (Romney),5
california,sandiego,431772,522136,0,953908,453166,502937,19984,976087,3022468,0.09473030942187297,0.05205610692571826,Dem (Obama),Dem (Obama),10
california,delnorte,4429,3869,0,8298,4256,3396,288,7940,28471,-0.06748614123885273,-0.11238891792995295,Rep (McCain),Rep (Romney),6
california,butte,39954,41474,0,81428,35312,32567,2284,70163,218635,0.018666797661737976,-0.040439605769089115,Dem (Obama),Rep (Romney),10
california,alpine,252,422,0,674,236,389,22,647,1176,0.2522255192878338,0.2448,Dem (Obama),Dem (Obama),1
california,kings,18105,13244,0,31349,17184,12282,673,30139,151122,-0.15506076748859612,-0.166361229892079,Rep (McCain),Rep (Romney),9
california,ventura,103256,132937,0,236193,131782,148006,6354,286142,809080,0.12566418141096475,0.057986761405063834,Dem (Obama),Dem (Obama),10
california,stanislaus,59549,61876,0,121425,69549,70609,3462,143620,509682,0.019164093061560635,0.007562893306125943,Dem (Obama),Dem (Obama),10
california,riverside,177324,191881,0,369205,290227,287754,11740,589721,2109464,0.03942796007638033,-0.00427868736169528,Dem (Obama),Rep (Romney),10
california,imperial,9027,13417,0,22444,9545,17464,444,27453,168052,0.19559793263232936,0.2931985634418157,Dem (Obama),Dem (Obama),9
california,humboldt,16704,30807,0,47511,15653,27757,2859,46269,133058,0.2968365220685736,0.27882976272748217,Dem (Obama),Dem (Obama),9
california,shasta,41482,24322,0,65804,45158,24199,1974,71331,176906,-0.2607744210078415,-0.30219011779632915,Rep (McCain),Rep (Romney),9
california,santaclara,140708,343266,0,483974,136347,343239,12101,491687,1739396,0.4185307475194949,0.431397079981484,Dem (Obama),Dem (Obama),10
california,fresno,94814,94788,0,189602,91143,85862,3239,180244,908830,-1.3712935517557831e-4,-0.029835315386571002,Rep (McCain),Rep (Romney),10
california,colusa,3273,2206,0,5479,3521,2248,96,5865,21165,-0.1947435663442234,-0.22066215981972612,Rep (McCain),Rep (Romney),5
california,sacramento,157752,233726,0,391478,177523,251365,10782,439670,1395144,0.19406965397800133,0.17217082315196508,Dem (Obama),Dem (Obama),10
california,modoc,2964,1301,0,4265,2779,1113,94,3986,9605,-0.3899179366940211,-0.42805755395683454,Rep (McCain),Rep (Romney),3
california,siskiyou,9288,7575,0,16863,9844,7110,551,17505,44690,-0.10158334815869062,-0.16125987967441313,Rep (McCain),Rep (Romney),7
california,glenn,5874,3693,0,9567,5608,3276,258,9142,27935,-0.2279711508309815,-0.2624943719045475,Rep (McCain),Rep (Romney),6
california,yolo,21486,46499,0,67985,19080,38856,1677,59613,196418,0.36791939398396706,0.34134217067108535,Dem (Obama),Dem (Obama),10
california,sanluisobispo,51812,57493,0,109305,56500,57655,3442,117597,265577,0.0519738346827684,0.01011782225920897,Dem (Obama),Dem (Obama),10
california,monterey,22052,48313,0,70365,25087,51712,1723,78522,407435,0.3732111134797129,0.34668420161720853,Dem (Obama),Dem (Obama),10
california,orange,430360,401605,0,831965,541592,457077,22646,1021315,2965525,-0.03456275203884779,-0.08462763938802546,Rep (McCain),Rep (Romney),10
california,yuba,9608,7107,0,16715,8746,5817,446,15009,71160,-0.14962608435536942,-0.201126141591705,Rep (McCain),Rep (Romney),8
california,tuolumne,13073,10262,0,23335,13410,9628,692,23730,56074,-0.120462824083994,-0.16416355586422432,Rep (McCain),Rep (Romney),8
california,marin,23242,88649,0,111891,23347,73450,2489,99286,248601,0.5845599735456829,0.5176090168083721,Dem (Obama),Dem (Obama),10
california,contracosta,111173,249241,0,360414,116867,239198,8250,364315,1024809,0.3830816782921862,0.3435636751716681,Dem (Obama),Dem (Obama),10
california,tehama,10626,6597,0,17223,10791,6032,533,17356,62575,-0.23393137084131685,-0.2828865244011175,Rep (McCain),Rep (Romney),8
california,napa,14251,28212,0,42463,11647,19964,721,32332,134051,0.3287803499517227,0.26310461548195246,Dem (Obama),Dem (Obama),9
california,sanjoaquin,74318,90851,0,165169,78794,98746,3548,181088,673613,0.10009747591860459,0.11238030866283655,Dem (Obama),Dem (Obama),10
california,sutter,10445,7360,0,17805,12576,8004,408,20988,93420,-0.17326593653468128,-0.22215743440233235,Rep (McCain),Rep (Romney),9
california,nevada,20899,23035,0,43934,15696,14261,907,30864,98186,0.048618382118632494,-0.047901992856427544,Dem (Obama),Rep (Romney),9
california,placer,80209,64460,0,144669,74460,49126,2739,126325,336477,-0.10886229945599955,-0.20499085656951435,Rep (McCain),Rep (Romney),10
california,solano,35898,66469,0,102367,48364,87225,2976,138565,410042,0.2986411636562564,0.28660879569876613,Dem (Obama),Dem (Obama),10
california,santabarbara,51056,80438,0,131494,59096,84279,3874,147249,416051,0.22344745767867735,0.17564428945074106,Dem (Obama),Dem (Obama),10
california,madera,20251,14997,0,35248,18990,12698,684,32372,147738,-0.14905810258738084,-0.19856096945215854,Rep (McCain),Rep (Romney),9
california,sierra,1157,743,0,1900,1056,652,71,1779,3366,-0.21789473684210525,-0.23653395784543327,Rep (McCain),Rep (Romney),1
california,inyo,3833,3208,0,7041,3541,2775,185,6501,18434,-0.08876580031245562,-0.12127929069031032,Rep (McCain),Rep (Romney),4
california,sanmateo,52353,156571,0,208924,56244,151036,4534,211814,704327,0.4988321111983305,0.4573137784639135,Dem (Obama),Dem (Obama),10
california,sanbenito,3566,5940,0,9506,6052,8617,303,14972,54492,0.249737008205344,0.17485854523144045,Dem (Obama),Dem (Obama),8
california,eldorado,40512,33010,0,73522,49661,34033,2229,85923,179053,-0.10203748537852615,-0.18672784190025568,Rep (McCain),Rep (Romney),9
california,mono,2159,2827,0,4986,2202,2574,141,4917,13905,0.13397513036502207,0.07788944723618091,Dem (Obama),Dem (Obama),4
california,mariposa,4880,3766,0,8646,4434,3080,291,7805,18290,-0.12884570899838074,-0.18019696566409368,Rep (McCain),Rep (Romney),4
california,calaveras,10979,8464,0,19443,10537,7404,528,18469,45994,-0.12935246618320217,-0.174627947160136,Rep (McCain),Rep (Romney),7
california,trinity,2904,3197,0,6101,2422,2367,241,5030,13701,0.048024913948533025,-0.011484652328252245,Dem (Obama),Rep (Romney),3
california,alameda,85646,349460,0,435106,106324,454344,16602,577270,1477980,0.6063212182778449,0.6207238508350753,Dem (Obama),Dem (Obama),10
california,sanbernardino,149342,166351,0,315693,245468,274203,12021,531692,2005287,0.053878293151891236,0.05529459985259905,Dem (Obama),Dem (Obama),10
california,plumas,5756,4524,0,10280,5240,3670,218,9128,20392,-0.1198443579766537,-0.17620650953984288,Rep (McCain),Rep (Romney),5
california,santacruz,20063,78495,0,98558,17132,61106,3056,81294,256901,0.5928691734816047,0.5620542447404074,Dem (Obama),Dem (Obama),10
california,merced,23994,28152,0,52146,23403,26128,1007,50538,250699,0.07973765964791163,0.05501605055419838,Dem (Obama),Dem (Obama),10
california,mendocino,6256,15963,0,22219,5129,11869,930,17928,87487,0.43687834736036724,0.39651723732203786,Dem (Obama),Dem (Obama),8
california,sanfrancisco,30888,198989,0,229877,44877,281226,11008,337111,789172,0.7312649808375784,0.7247679414172823,Dem (Obama),Dem (Obama),10
california,lassen,6541,3246,0,9787,7261,3044,298,10603,35081,-0.33667109430877695,-0.4092188258127123,Rep (McCain),Rep (Romney),6
california,kern,111254,76189,0,187443,119065,80257,4509,203831,815693,-0.1870702026749465,-0.19470003311225054,Rep (McCain),Rep (Romney),10
california,amador,9818,7321,0,17139,8903,6001,399,15303,38327,-0.14569111383394598,-0.1947128287707998,Rep (McCain),Rep (Romney),7
california,tulare,44729,32670,0,77399,42186,29191,1455,72832,429404,-0.15580304655098903,-0.18206144836572005,Rep (McCain),Rep (Romney),10
california,sonoma,47184,144399,0,191583,45666,124504,5568,175738,474047,0.5074301999655502,0.46328965152494567,Dem (Obama),Dem (Obama),10
california,losangeles,766164,1845726,0,2611890,754974,1781383,60558,2596915,9758256,0.41332598233463125,0.4046784423486126,Dem (Obama),Dem (Obama),10
california,lake,8034,11986,0,20020,6474,9159,641,16274,64371,0.1974025974025974,0.1717520629437728,Dem (Obama),Dem (Obama),8
colorado,sanjuan,218,264,0,482,212,266,28,506,752,0.0954356846473029,0.11297071129707113,Dem (Obama),Dem (Obama),1
colorado,montrose,10964,5911,0,16875,12789,5852,413,19054,40266,-0.29943703703703706,-0.37213668794592564,Rep (McCain),Rep (Romney),7
colorado,douglas,73225,51813,0,125038,93930,54093,2137,150160,273440,-0.17124394184168013,-0.2691270951135972,Rep (McCain),Rep (Romney),10
colorado,bent,1062,781,0,1843,1053,778,50,1881,6125,-0.15246880086814976,-0.15019115237575095,Rep (McCain),Rep (Romney),2
colorado,saguache,913,1620,0,2533,937,1762,97,2796,6161,0.27911567311488356,0.3056687662097073,Dem (Obama),Dem (Obama),2
colorado,archuleta,3618,2822,0,6440,3831,2637,178,6646,12136,-0.12360248447204969,-0.18460111317254174,Rep (McCain),Rep (Romney),3
colorado,riogrande,1400,1130,0,2530,2892,2428,133,5453,11926,-0.1067193675889328,-0.08721804511278196,Rep (McCain),Rep (Romney),3
colorado,hinsdale,343,239,0,582,352,228,18,598,489,-0.17869415807560138,-0.21379310344827587,Rep (McCain),Rep (Romney),1
colorado,pueblo,27102,35442,0,62544,31023,40624,1659,73306,156244,0.13334612432847276,0.13400421511019303,Dem (Obama),Dem (Obama),9
colorado,phillips,1513,587,0,2100,1637,588,40,2265,4394,-0.44095238095238093,-0.47146067415730336,Rep (McCain),Rep (Romney),1
colorado,kiowa,630,172,0,802,677,118,26,821,1643,-0.571072319201995,-0.7031446540880503,Rep (McCain),Rep (Romney),1
colorado,gunnison,3112,5512,0,8624,3106,4563,243,7912,15136,0.2782931354359926,0.18998565653931412,Dem (Obama),Dem (Obama),4
colorado,prowers,3026,1464,0,4490,3200,1498,111,4809,12734,-0.34788418708240537,-0.362281822051937,Rep (McCain),Rep (Romney),3
colorado,eagle,8112,13055,0,21167,9317,12598,459,22374,50793,0.23352388151367695,0.14971480720967373,Dem (Obama),Dem (Obama),7
colorado,chaffee,4832,4827,0,9659,4949,4967,301,10217,17540,-5.17651930841702e-4,0.0018152480839048004,Rep (McCain),Dem (Obama),4
colorado,alamosa,2635,3521,0,6156,2693,3782,196,6671,15293,0.14392462638076672,0.1681853281853282,Dem (Obama),Dem (Obama),4
colorado,delta,9905,5007,0,14912,10762,4542,377,15681,30533,-0.32846030042918456,-0.40642969158389963,Rep (McCain),Rep (Romney),6
colorado,otero,4324,3454,0,7778,4315,3566,158,8039,18830,-0.11185394703008486,-0.09503870067250349,Rep (McCain),Rep (Romney),4
colorado,boulder,15265,46948,0,62213,48526,120485,4196,173207,290177,0.5092665520068153,0.42576518688132725,Dem (Obama),Dem (Obama),10
colorado,mineral,334,270,0,604,344,291,15,650,1020,-0.10596026490066225,-0.08346456692913386,Rep (McCain),Rep (Romney),1
colorado,grand,4088,3961,0,8049,4149,3575,237,7961,14526,-0.015778357559945336,-0.07431382703262558,Rep (McCain),Rep (Romney),4
colorado,laplata,11170,15422,0,26592,12554,15063,858,28475,50149,0.15989771359807461,0.09084983886736431,Dem (Obama),Dem (Obama),7
colorado,crowley,976,552,0,1528,924,535,43,1502,5897,-0.2774869109947644,-0.26662097326936257,Rep (McCain),Rep (Romney),2
colorado,pitkin,2448,7260,0,9708,2941,6648,190,9779,16389,0.4956736711990111,0.3865887996662843,Dem (Obama),Dem (Obama),4
colorado,gilpin,1249,1944,0,3193,1320,1854,97,3271,5126,0.21766363921077356,0.16824196597353497,Dem (Obama),Dem (Obama),1
colorado,adams,39070,55233,0,94303,66531,90843,4121,161495,425330,0.17139433528095607,0.1544854931564299,Dem (Obama),Dem (Obama),10
colorado,logan,5986,2837,0,8823,6124,2675,231,9030,22278,-0.35690808115153577,-0.39197636095010796,Rep (McCain),Rep (Romney),5
colorado,weld,55913,46644,0,102557,62350,47418,2927,112695,242860,-0.09037900874635568,-0.1360323591574958,Rep (McCain),Rep (Romney),10
colorado,jackson,624,277,0,901,600,216,32,848,1464,-0.3851276359600444,-0.47058823529411764,Rep (McCain),Rep (Romney),1
colorado,fremont,12595,6801,0,19396,13087,6644,527,20258,46941,-0.29872138585275315,-0.326541989762303,Rep (McCain),Rep (Romney),7
colorado,washington,1935,518,0,2453,2059,461,47,2567,4773,-0.5776600081532817,-0.6341269841269841,Rep (McCain),Rep (Romney),1
colorado,baca,1568,532,0,2100,1554,462,80,2096,3833,-0.49333333333333335,-0.5416666666666666,Rep (McCain),Rep (Romney),1
colorado,montezuma,6913,4619,0,11532,7372,4486,374,12232,25279,-0.1989247311827957,-0.24337999662674986,Rep (McCain),Rep (Romney),5
colorado,kitcarson,2420,898,0,3318,2664,789,72,3525,8156,-0.458710066305003,-0.5430060816681147,Rep (McCain),Rep (Romney),2
colorado,sanmiguel,930,3345,0,4275,1144,2961,110,4215,7299,0.5649122807017544,0.4426309378806334,Dem (Obama),Dem (Obama),2
colorado,moffat,4101,1566,0,5667,4616,1291,135,6042,13519,-0.4473266278454209,-0.5628914846791941,Rep (McCain),Rep (Romney),3
colorado,broomfield,12675,16031,0,28706,14765,16653,773,32191,52872,0.11690935692886505,0.060092940352664076,Dem (Obama),Dem (Obama),8
colorado,jefferson,129291,155020,0,284311,139960,153069,7122,300151,528614,0.0904959709613768,0.04473618652078804,Dem (Obama),Dem (Obama),10
colorado,elbert,9030,3775,0,12805,10148,3542,303,13993,22712,-0.41038656774697385,-0.48254200146092036,Rep (McCain),Rep (Romney),5
colorado,sedgwick,857,468,0,1325,881,419,37,1337,2412,-0.29358490566037737,-0.3553846153846154,Rep (McCain),Rep (Romney),1
colorado,arapahoe,100409,128366,0,228775,114232,135433,5081,254746,552860,0.12220303791935308,0.08491778983838344,Dem (Obama),Dem (Obama),10
colorado,garfield,10932,10847,0,21779,12159,10989,547,23695,54761,-0.0039028421874282566,-0.05054432348367029,Rep (McCain),Rep (Romney),8
colorado,conejos,1616,2106,0,3722,1794,2180,53,4027,8220,0.13164965072541646,0.09713135379969803,Dem (Obama),Dem (Obama),2
colorado,morgan,6222,3762,0,9984,6461,3761,256,10478,27911,-0.24639423076923078,-0.2641361768734103,Rep (McCain),Rep (Romney),6
colorado,huerfano,1547,1946,0,3493,1615,1897,111,3623,6948,0.11422845691382766,0.08029612756264237,Dem (Obama),Dem (Obama),2
colorado,denver,60226,195499,0,255725,69755,209759,6050,285564,578087,0.5289783947599961,0.5008836766673583,Dem (Obama),Dem (Obama),10
colorado,lasanimas,3033,3483,0,6516,3105,3282,145,6532,15675,0.06906077348066299,0.027712541099107563,Dem (Obama),Dem (Obama),4
colorado,yuma,3238,1105,0,4343,3433,950,98,4481,9896,-0.4911351600276307,-0.566506958704084,Rep (McCain),Rep (Romney),3
colorado,larimer,68932,84461,0,153393,74603,83103,4117,161823,291162,0.10123669267828389,0.05389775912140312,Dem (Obama),Dem (Obama),10
colorado,clearcreek,2278,3295,0,5573,2381,3041,188,5610,9088,0.18248699084873496,0.1217263002582073,Dem (Obama),Dem (Obama),2
colorado,rioblanco,2425,654,0,3079,2677,561,73,3311,6494,-0.5751867489444625,-0.6534898085237801,Rep (McCain),Rep (Romney),2
colorado,costilla,411,1236,0,1647,440,1317,47,1804,3536,0.5009107468123861,0.4991462720546386,Dem (Obama),Dem (Obama),1
colorado,cheyenne,890,198,0,1088,858,162,25,1045,2194,-0.6360294117647058,-0.6823529411764706,Rep (McCain),Rep (Romney),1
colorado,teller,7939,4370,0,12309,7909,3894,341,12144,22821,-0.2899504427654562,-0.3401677539608574,Rep (McCain),Rep (Romney),5
colorado,ouray,1360,1629,0,2989,1470,1640,73,3183,4319,0.0899966543994647,0.05466237942122187,Dem (Obama),Dem (Obama),1
colorado,elpaso,155914,104670,0,260584,163819,104989,6796,275604,599988,-0.1966506001903417,-0.2188550935984048,Rep (McCain),Rep (Romney),10
colorado,park,4835,4196,0,9031,5085,3721,248,9054,16286,-0.07075628391097331,-0.15489439018850784,Rep (McCain),Rep (Romney),4
colorado,dolores,803,356,0,1159,838,329,51,1218,2027,-0.3856773080241588,-0.4361610968294773,Rep (McCain),Rep (Romney),1
colorado,custer,1668,914,0,2582,1776,862,59,2697,3899,-0.29202168861347794,-0.3464746019711903,Rep (McCain),Rep (Romney),1
colorado,summit,4845,9700,0,14545,5495,9169,374,15038,27105,0.3337916809900309,0.2505455537370431,Dem (Obama),Dem (Obama),6
colorado,lincoln,1683,543,0,2226,1663,537,48,2248,5476,-0.5121293800539084,-0.5118181818181818,Rep (McCain),Rep (Romney),2
colorado,routt,4634,8133,0,12767,5361,7389,288,13038,22924,0.2740659512806454,0.15905882352941175,Dem (Obama),Dem (Obama),5
colorado,mesa,43669,23470,0,67139,45087,22448,1498,69033,142284,-0.3008534532834865,-0.3352187754497668,Rep (McCain),Rep (Romney),9
colorado,lake,1076,1847,0,2923,1087,1807,99,2993,7039,0.2637700992131372,0.248790601243953,Dem (Obama),Dem (Obama),2
connecticut,middlesex,32886,52848,0,85734,34533,47851,1063,83447,164774,0.23283644761704808,0.16165760341813945,Dem (Obama),Dem (Obama),9
connecticut,tolland,29543,44874,0,74417,30391,39283,1106,70780,151073,0.20601475469314806,0.12762292964376956,Dem (Obama),Dem (Obama),9
connecticut,newlondon,47829,73631,0,121460,45715,66510,1818,114043,272360,0.21243207640375433,0.18529739362887057,Dem (Obama),Dem (Obama),10
connecticut,newhaven,140481,215832,0,356313,137942,230040,3801,371783,856688,0.21147418140791943,0.2502785462332397,Dem (Obama),Dem (Obama),10
connecticut,windham,21324,28399,0,49723,19758,25953,923,46634,117708,0.14228827705488406,0.13552536588567304,Dem (Obama),Dem (Obama),9
connecticut,hartford,136330,259605,0,395935,143648,244314,4523,392485,887976,0.3113516107441878,0.2594738659971853,Dem (Obama),Dem (Obama),10
connecticut,fairfield,158064,224624,0,382688,172238,214757,3616,390611,905342,0.17392758591855506,0.10986963655861187,Dem (Obama),Dem (Obama),10
connecticut,litchfield,39811,44006,0,83817,47207,43823,1374,92404,189916,0.05004951262870301,-0.03717455783807536,Dem (Obama),Rep (Romney),9
delaware,newcastle,74595,178712,0,253307,81226,167051,3683,251960,533514,0.4110308834734137,0.3456824433999122,Dem (Obama),Dem (Obama),10
delaware,kent,29822,36383,0,66205,32134,35525,1010,68669,156918,0.09910127633864511,0.05011897899762042,Dem (Obama),Dem (Obama),9
delaware,sussex,47939,40299,0,88238,52116,39971,1128,93215,190846,-0.08658401142364967,-0.13188615113968313,Rep (McCain),Rep (Romney),9
florida,walton,19527,7158,0,26685,21483,6665,332,28480,53366,-0.4635188308038224,-0.526431718061674,Rep (McCain),Rep (Romney),8
florida,baker,8672,2326,0,10998,8974,2310,82,11366,26548,-0.5770140025459174,-0.5905707196029777,Rep (McCain),Rep (Romney),6
florida,polk,128658,113552,0,242210,131566,114610,2482,248658,590116,-0.06236736716072829,-0.06887755102040816,Rep (McCain),Rep (Romney),10
florida,levy,11751,6707,0,18458,12052,6118,226,18396,40415,-0.2732690432332864,-0.3265822784810127,Rep (McCain),Rep (Romney),7
florida,hardee,4758,2561,0,7319,4694,2461,67,7222,27521,-0.30017761989342806,-0.3120894479385045,Rep (McCain),Rep (Romney),6
florida,osceola,39489,59081,0,98570,40581,67201,865,108647,258531,0.19876230090291164,0.24698001521589877,Dem (Obama),Dem (Obama),10
florida,lee,145624,117878,0,263502,154112,110080,1842,266034,606165,-0.10529711349439473,-0.16666666666666666,Rep (McCain),Rep (Romney),10
florida,gulf,4971,2144,0,7115,4995,2013,99,7107,15879,-0.3973295853829937,-0.425513698630137,Rep (McCain),Rep (Romney),4
florida,desoto,5625,4378,0,10003,5587,4174,102,9863,34557,-0.12466260121963411,-0.1447597582214937,Rep (McCain),Rep (Romney),6
florida,pinellas,206909,243994,0,450903,213192,238966,5326,457484,918263,0.08224607066264807,0.05700219834659566,Dem (Obama),Dem (Obama),10
florida,miami-dade,351462,491195,0,842657,332602,540776,3867,877245,2445374,0.1658242914970148,0.23835498489771897,Dem (Obama),Dem (Obama),10
florida,marion,89571,70771,0,160342,93036,66823,1509,161368,326833,-0.11724937945142258,-0.163975753632889,Rep (McCain),Rep (Romney),10
florida,highlands,25903,17913,0,43816,25912,16147,381,42440,98807,-0.18235347818148623,-0.23217385101880691,Rep (McCain),Rep (Romney),9
florida,gadsden,6805,15566,0,22371,6628,15768,99,22495,46031,0.39162308345626035,0.40810859081978923,Dem (Obama),Dem (Obama),7
florida,volusia,113716,127474,0,241190,117473,114716,2294,234483,496053,0.05704216592727725,-0.011873947516893565,Dem (Obama),Rep (Romney),10
florida,glades,2533,1674,0,4207,2344,1603,42,3989,12617,-0.20418350368433563,-0.18773752216873574,Rep (McCain),Rep (Romney),3
florida,columbia,18668,9171,0,27839,18429,8462,272,27163,66964,-0.34114012715973996,-0.3706444535346398,Rep (McCain),Rep (Romney),8
florida,calhoun,4344,1821,0,6165,4366,1664,122,6152,14372,-0.4092457420924574,-0.4480928689883914,Rep (McCain),Rep (Romney),4
florida,stlucie,52323,66830,0,119153,56202,65869,955,123026,269659,0.12175102599179206,0.07919161799280747,Dem (Obama),Dem (Obama),10
florida,okaloosa,68181,25623,0,93804,70143,23390,1206,94739,182076,-0.45369067417167713,-0.49985566591470393,Rep (McCain),Rep (Romney),9
florida,sarasota,102650,102413,0,205063,110489,95089,1856,207434,376200,-0.001155742381609554,-0.07491073947601397,Rep (McCain),Rep (Romney),10
florida,orange,186079,271866,0,457945,189057,274227,4101,467385,1116094,0.1873303562654904,0.18383971818582123,Dem (Obama),Dem (Obama),10
florida,indianriver,39972,29565,0,69537,43441,27483,521,71445,135518,-0.14966133137754,-0.22500140995995713,Rep (McCain),Rep (Romney),9
florida,flagler,23931,24682,0,48613,26966,23204,419,50589,91806,0.015448542570917245,-0.07498505082718757,Dem (Obama),Rep (Romney),9
florida,clay,66847,26635,0,93482,69996,25745,808,96549,186076,-0.4301576774138337,-0.46219487993649533,Rep (McCain),Rep (Romney),9
florida,broward,225453,474579,0,700032,243732,507430,4004,755166,1734139,0.35587801700493693,0.351053434545411,Dem (Obama),Dem (Obama),10
florida,suwannee,11672,4572,0,16244,12672,4749,206,17627,40675,-0.43708446195518347,-0.4547959359393835,Rep (McCain),Rep (Romney),7
florida,bay,56597,23603,0,80200,56863,22037,934,79834,166798,-0.41139650872817957,-0.4413941698352345,Rep (McCain),Rep (Romney),9
florida,taylor,6446,2787,0,9233,6249,2761,107,9117,22000,-0.39629589515867,-0.38712541620421753,Rep (McCain),Rep (Romney),5
florida,hillsborough,188096,192320,0,380416,249904,286158,5441,541503,1200236,0.01110363391655451,0.06763023680096705,Dem (Obama),Dem (Obama),10
florida,jackson,13695,7632,0,21327,13417,7342,181,20940,49334,-0.2842875228583486,-0.29264415434269475,Rep (McCain),Rep (Romney),7
florida,escambia,90826,61152,0,151978,88671,58154,1605,148430,297940,-0.19525194436036794,-0.20784607525966287,Rep (McCain),Rep (Romney),10
florida,washington,8165,2858,0,11023,8037,2820,141,10998,24125,-0.48144788170189606,-0.4805194805194805,Rep (McCain),Rep (Romney),5
florida,palmbeach,211163,342527,0,553690,247257,349418,3666,600341,1299356,0.23725189185284185,0.17121716177148363,Dem (Obama),Dem (Obama),10
florida,hernando,25220,18980,0,44200,44906,37791,896,83593,170337,-0.1411764705882353,-0.08603697836680896,Rep (McCain),Rep (Romney),9
florida,sumter,30859,17644,0,48503,40644,19519,308,60471,85891,-0.2724573737706946,-0.35112943171051975,Rep (McCain),Rep (Romney),8
florida,pasco,109902,102217,0,212119,112335,98148,2875,213358,456514,-0.03622966353791975,-0.06740211798577557,Rep (McCain),Rep (Romney),10
florida,monroe,18906,20868,0,39774,19234,19392,419,39045,73065,0.049328707195655457,0.004090508983586185,Dem (Obama),Dem (Obama),8
florida,liberty,2337,892,0,3229,2301,942,41,3284,8230,-0.4475069681015794,-0.41905642923219244,Rep (McCain),Rep (Romney),2
florida,jefferson,3794,4082,0,7876,3808,3945,55,7808,14583,0.036566785170137124,0.0176705791306591,Dem (Obama),Dem (Obama),4
florida,citrus,43666,31428,0,75094,44657,28453,813,73923,140686,-0.16296907875462754,-0.22163862672684995,Rep (McCain),Rep (Romney),9
florida,charlotte,45180,39006,0,84186,47988,35896,780,84664,159385,-0.07333760957878982,-0.14415144723666015,Rep (McCain),Rep (Romney),9
florida,lafayette,2677,640,0,3317,2668,687,44,3399,8506,-0.6141091347603256,-0.5904619970193741,Rep (McCain),Rep (Romney),2
florida,hamilton,3179,2360,0,5539,3137,2226,41,5404,14696,-0.14786062466149125,-0.1698676114115234,Rep (McCain),Rep (Romney),4
florida,stjohns,68800,35578,0,104378,78490,35155,1088,114733,180624,-0.31828546245377376,-0.38131901975449867,Rep (McCain),Rep (Romney),9
florida,nassau,27326,10577,0,37903,29926,10249,348,40523,71099,-0.44189114318127853,-0.48978220286247665,Rep (McCain),Rep (Romney),8
florida,gilchrist,5654,1993,0,7647,5917,1885,106,7908,16683,-0.47874983653720415,-0.5167905665214048,Rep (McCain),Rep (Romney),4
florida,leon,55521,91356,0,146877,55806,90863,1666,148335,270409,0.24397965644723135,0.23902119739004152,Dem (Obama),Dem (Obama),10
florida,putnam,19586,13201,0,32787,19326,11666,331,31323,74715,-0.19474181840363558,-0.24716055756324212,Rep (McCain),Rep (Romney),8
florida,manatee,78040,67785,0,145825,85616,66476,1359,153451,318619,-0.07032401851534373,-0.12584488336007155,Rep (McCain),Rep (Romney),10
florida,hendry,5779,4998,0,10777,5355,4751,79,10185,39030,-0.07246914725804955,-0.05976647536117158,Rep (McCain),Rep (Romney),7
florida,alachua,47025,73134,0,120159,48765,69634,1919,120318,244247,0.21728709459965545,0.17625993462782624,Dem (Obama),Dem (Obama),10
florida,santarosa,55843,19394,0,75237,58169,17757,890,76816,147838,-0.4844557863817005,-0.5322550904828386,Rep (McCain),Rep (Romney),9
florida,brevard,157402,127400,0,284802,159270,122972,3262,285504,540583,-0.1053433613527995,-0.12860594808710255,Rep (McCain),Rep (Romney),10
florida,seminole,104885,99140,0,204025,109939,96435,2231,208605,417330,-0.028158313932116163,-0.06543459931968175,Rep (McCain),Rep (Romney),10
florida,martin,44110,33474,0,77584,48180,30097,583,78860,144322,-0.13709012167457207,-0.23101294122155933,Rep (McCain),Rep (Romney),9
florida,madison,4544,4270,0,8814,4474,4174,64,8712,19300,-0.031086907193101882,-0.03469010175763182,Rep (McCain),Rep (Romney),5
florida,duval,197171,192173,0,389344,211553,196657,3492,411702,854848,-0.012836977069121394,-0.03649102177800642,Rep (McCain),Rep (Romney),10
florida,wakulla,8869,5303,0,14172,9288,5173,195,14656,29368,-0.25162291843070844,-0.28455846760251713,Rep (McCain),Rep (Romney),6
florida,franklin,3799,2122,0,5921,3570,1845,59,5474,11470,-0.2832291842594156,-0.3185595567867036,Rep (McCain),Rep (Romney),3
florida,dixie,5188,1921,0,7109,5052,1798,91,6941,16196,-0.45955830637220424,-0.475036496350365,Rep (McCain),Rep (Romney),4
florida,holmes,7023,1443,0,8466,6919,1264,91,8274,19992,-0.6591070163004961,-0.6910668459000366,Rep (McCain),Rep (Romney),5
florida,union,3933,1299,0,5232,3980,1339,74,5393,15375,-0.5034403669724771,-0.49652190261327317,Rep (McCain),Rep (Romney),4
florida,okeechobee,7551,5102,0,12653,7325,4856,140,12321,39883,-0.1935509365367897,-0.20269271816763812,Rep (McCain),Rep (Romney),7
florida,collier,83238,52710,0,135948,96508,51678,894,149080,316931,-0.2245564480536676,-0.302525204810171,Rep (McCain),Rep (Romney),10
florida,bradford,8135,3430,0,11565,8216,3324,91,11631,28750,-0.40683095546908776,-0.4239168110918544,Rep (McCain),Rep (Romney),6
florida,lake,82512,62710,0,145222,87637,61790,1369,150796,291671,-0.13635675035462946,-0.1729740943738414,Rep (McCain),Rep (Romney),10
georgia,rabun,5482,2000,0,7482,5753,1558,127,7438,16266,-0.4653835872761294,-0.573792914785939,Rep (McCain),Rep (Romney),4
georgia,decatur,5794,4348,0,10142,5816,4580,69,10465,27920,-0.1425754289094853,-0.11889188149288188,Rep (McCain),Rep (Romney),6
georgia,richmond,26813,51948,0,78761,25821,52461,583,78865,198170,0.3191300262820431,0.34030811680846174,Dem (Obama),Dem (Obama),10
georgia,tift,9421,4731,0,14152,9171,4640,82,13893,39823,-0.33140192198982477,-0.32807182680472086,Rep (McCain),Rep (Romney),7
georgia,toombs,6651,2956,0,9607,6519,2740,74,9333,27151,-0.38461538461538464,-0.40814342801598447,Rep (McCain),Rep (Romney),6
georgia,bacon,3089,816,0,3905,3092,791,46,3929,10969,-0.5820742637644046,-0.5925830543394283,Rep (McCain),Rep (Romney),3
georgia,grady,5775,3539,0,9314,5922,3419,50,9391,24738,-0.2400687137642259,-0.26795846269136064,Rep (McCain),Rep (Romney),5
georgia,echols,981,201,0,1182,917,173,12,1102,3973,-0.6598984771573604,-0.6825688073394496,Rep (McCain),Rep (Romney),1
georgia,bryan,9105,3630,0,12735,9537,3695,171,13403,29039,-0.4299175500588928,-0.44150544135429265,Rep (McCain),Rep (Romney),6
georgia,columbia,39283,15680,0,54963,41724,16420,698,58842,117858,-0.4294343467423539,-0.4351953769950468,Rep (McCain),Rep (Romney),9
georgia,evans,2459,1373,0,3832,2267,1266,27,3560,10966,-0.28340292275574114,-0.2833286159071611,Rep (McCain),Rep (Romney),3
georgia,muscogee,29524,44036,0,73560,27469,42458,483,70410,187629,0.19728113104948342,0.21435211005763152,Dem (Obama),Dem (Obama),9
georgia,pickens,10003,2595,0,12598,10547,1975,151,12673,29155,-0.5880298460073028,-0.6845551828781344,Rep (McCain),Rep (Romney),6
georgia,banks,5114,1026,0,6140,5353,779,59,6191,17840,-0.6657980456026059,-0.7459230267449446,Rep (McCain),Rep (Romney),4
georgia,wilcox,2158,978,0,3136,2050,1059,15,3124,9041,-0.3762755102040816,-0.3187520102926986,Rep (McCain),Rep (Romney),2
georgia,randolph,1366,1811,0,3177,1249,1749,17,3015,7724,0.14006924771797294,0.1667778519012675,Dem (Obama),Dem (Obama),2
georgia,bibb,26981,38851,0,65832,25606,38538,481,64625,154810,0.18030744926479525,0.2016088800199551,Dem (Obama),Dem (Obama),9
georgia,jackson,17772,4947,0,22719,19122,4236,312,23670,58347,-0.5645054799947181,-0.6372977138453635,Rep (McCain),Rep (Romney),8
georgia,wheeler,1408,794,0,2202,1366,772,22,2160,7093,-0.27883742052679383,-0.2778297474275023,Rep (McCain),Rep (Romney),2
georgia,monroe,7921,4095,0,12016,8352,3779,128,12259,25864,-0.3184087882822903,-0.3769680982606545,Rep (McCain),Rep (Romney),5
georgia,dodge,5542,2593,0,8135,5214,2440,77,7731,21402,-0.3625076828518746,-0.3624248758818918,Rep (McCain),Rep (Romney),5
georgia,liberty,5818,10453,0,16271,5558,10427,147,16132,63854,0.28486263905107245,0.30459806068188927,Dem (Obama),Dem (Obama),8
georgia,towns,4279,1387,0,5666,4834,1265,60,6159,10430,-0.5104129897635016,-0.5851778980160682,Rep (McCain),Rep (Romney),3
georgia,oglethorpe,4142,2228,0,6370,4250,1913,95,6258,14556,-0.30047095761381476,-0.3791984423170534,Rep (McCain),Rep (Romney),4
georgia,morgan,5982,3090,0,9072,6178,2751,87,9016,17741,-0.3187830687830688,-0.38380557733228804,Rep (McCain),Rep (Romney),4
georgia,butts,5944,3064,0,9008,6306,2966,100,9372,23401,-0.3197158081705151,-0.36022433132010356,Rep (McCain),Rep (Romney),5
georgia,putnam,5960,3096,0,9056,6210,2917,78,9205,20925,-0.31625441696113077,-0.3607976333954202,Rep (McCain),Rep (Romney),5
georgia,bartow,25930,9630,0,35560,26847,8383,508,35738,97423,-0.4583802024746907,-0.5240987794493329,Rep (McCain),Rep (Romney),9
georgia,haralson,8649,2247,0,10896,8439,1787,136,10362,28574,-0.5875550660792952,-0.6504987287306865,Rep (McCain),Rep (Romney),6
georgia,madison,8224,2957,0,11181,8441,2486,152,11079,27798,-0.4710669886414453,-0.5449803239681523,Rep (McCain),Rep (Romney),6
georgia,pierce,5499,1252,0,6751,5666,1124,55,6845,18205,-0.6290919863723893,-0.6689248895434462,Rep (McCain),Rep (Romney),4
georgia,webster,587,514,0,1101,598,573,4,1175,2727,-0.06630336058128973,-0.02134927412467976,Rep (McCain),Rep (Romney),1
georgia,clayton,16492,82404,0,98896,14158,81439,423,96020,260156,0.6664779161947905,0.7037982363463289,Dem (Obama),Dem (Obama),10
georgia,baker,828,842,0,1670,784,790,10,1584,3657,0.008383233532934131,0.0038119440914866584,Dem (Obama),Dem (Obama),1
georgia,douglas,26773,27766,0,54539,26226,28410,565,55201,127800,0.01820715451328407,0.039973643751372724,Dem (Obama),Dem (Obama),9
georgia,berrien,4889,1468,0,6357,4837,1268,82,6187,18708,-0.5381469246499921,-0.5846027846027846,Rep (McCain),Rep (Romney),4
georgia,lee,9923,3100,0,13023,10310,3187,110,13607,27998,-0.5239192198418183,-0.5277469067200119,Rep (McCain),Rep (Romney),6
georgia,lumpkin,8312,2581,0,10893,8633,2049,196,10878,28875,-0.5261176902597998,-0.6163639767833738,Rep (McCain),Rep (Romney),6
georgia,barrow,17613,6651,0,24264,18719,6019,433,25171,66359,-0.45178041543026703,-0.513380224755437,Rep (McCain),Rep (Romney),8
georgia,pike,6542,1574,0,8116,6660,1355,84,8099,17411,-0.6121241991128635,-0.6618839675608235,Rep (McCain),Rep (Romney),4
georgia,glascock,1202,210,0,1412,1135,176,22,1333,3007,-0.7025495750708215,-0.7315026697177727,Rep (McCain),Rep (Romney),1
georgia,cook,3781,2072,0,5853,3934,2042,51,6027,16976,-0.29198701520587733,-0.31659973226238286,Rep (McCain),Rep (Romney),4
georgia,stephens,7678,2698,0,10376,7207,2123,137,9467,25876,-0.4799537393986122,-0.5449088960342979,Rep (McCain),Rep (Romney),5
georgia,atkinson,1939,932,0,2871,1938,930,34,2902,8332,-0.3507488679902473,-0.3514644351464435,Rep (McCain),Rep (Romney),2
georgia,bulloch,14120,9540,0,23660,14159,9572,301,24032,67298,-0.19357565511411665,-0.19329147528549154,Rep (McCain),Rep (Romney),8
georgia,long,2117,1281,0,3398,2300,1434,52,3786,13142,-0.24602707474985286,-0.23192287091590788,Rep (McCain),Rep (Romney),3
georgia,crisp,4420,3076,0,7496,4179,3160,47,7386,23182,-0.17929562433297758,-0.13884725439433165,Rep (McCain),Rep (Romney),5
georgia,habersham,11764,2898,0,14662,12148,2297,155,14600,42212,-0.6046924021279498,-0.6819660782277605,Rep (McCain),Rep (Romney),7
georgia,macon,1712,3251,0,4963,1545,3211,25,4781,14553,0.310094700785815,0.3502943650126156,Dem (Obama),Dem (Obama),4
georgia,clay,557,878,0,1435,537,862,3,1402,2981,0.22369337979094076,0.23230879199428162,Dem (Obama),Dem (Obama),1
georgia,cherokee,70232,22318,0,92550,76473,19813,1755,98041,206283,-0.5177093462992977,-0.5884552271358245,Rep (McCain),Rep (Romney),10
georgia,colquitt,9182,4138,0,13320,9240,3971,108,13319,44712,-0.37867867867867866,-0.398834304746045,Rep (McCain),Rep (Romney),7
georgia,effingham,15230,4936,0,20166,15591,4941,247,20779,50513,-0.5104631558068036,-0.5187025131502045,Rep (McCain),Rep (Romney),7
georgia,dougherty,12534,26087,0,38621,11441,26209,172,37822,94514,0.35092307293959246,0.39224435590969453,Dem (Obama),Dem (Obama),9
georgia,fulton,107338,244025,0,351363,133837,248479,4529,386845,886982,0.38901933328210425,0.2998618943491771,Dem (Obama),Dem (Obama),10
georgia,laurens,12049,7757,0,19806,11947,7508,136,19591,48034,-0.2167020094920731,-0.22816756617836031,Rep (McCain),Rep (Romney),7
georgia,warren,1086,1552,0,2638,990,1525,7,2522,5936,0.17664897649734648,0.21272365805168986,Dem (Obama),Dem (Obama),2
georgia,brantley,5072,1116,0,6188,4963,939,99,6001,17650,-0.6393018745959922,-0.6818027787190782,Rep (McCain),Rep (Romney),4
georgia,fannin,7799,2606,0,10405,7853,2027,127,10007,23337,-0.4990869774147045,-0.5896761133603239,Rep (McCain),Rep (Romney),5
georgia,charlton,2458,1193,0,3651,2527,1197,39,3763,12310,-0.3464804163242947,-0.35714285714285715,Rep (McCain),Rep (Romney),3
georgia,cobb,170591,140535,0,311126,171464,132526,4999,308989,677402,-0.09660394823961996,-0.12808973979407218,Rep (McCain),Rep (Romney),10
georgia,telfair,2486,1862,0,4348,2479,1804,51,4334,16052,-0.14351425942962281,-0.1575998132150362,Rep (McCain),Rep (Romney),4
georgia,emanuel,5105,3060,0,8165,5086,2919,55,8060,22348,-0.25045927740355173,-0.2707058088694566,Rep (McCain),Rep (Romney),5
georgia,catoosa,18214,6024,0,24238,17848,5357,434,23639,62951,-0.5029292845944385,-0.5382891618185736,Rep (McCain),Rep (Romney),8
georgia,coweta,37535,15496,0,53031,39633,15156,723,55512,121528,-0.4155871094265618,-0.44675026008870394,Rep (McCain),Rep (Romney),9
georgia,white,8465,2173,0,10638,8647,1670,154,10471,26498,-0.5914645610077082,-0.6762624794029272,Rep (McCain),Rep (Romney),6
georgia,lamar,4871,2745,0,7616,4896,2602,91,7589,17837,-0.27914915966386555,-0.3059482528674313,Rep (McCain),Rep (Romney),4
georgia,gwinnett,158251,128342,0,286593,159563,131879,4118,295560,778022,-0.10436053916180786,-0.09498974066881231,Rep (McCain),Rep (Romney),10
georgia,troup,15374,10438,0,25812,15170,10545,260,25975,65652,-0.19122888578955524,-0.17985611510791366,Rep (McCain),Rep (Romney),8
georgia,crawford,3354,1831,0,5185,3366,1699,58,5123,12821,-0.29373191899710704,-0.32912142152023693,Rep (McCain),Rep (Romney),3
georgia,ware,8299,4020,0,12319,7933,3892,98,11923,36006,-0.34734962253429663,-0.3417336152219873,Rep (McCain),Rep (Romney),6
georgia,peach,5171,5923,0,11094,5280,6141,78,11499,26883,0.06778438795745448,0.07538744418177042,Dem (Obama),Dem (Obama),6
georgia,lanier,1781,1058,0,2839,1812,1108,38,2958,9404,-0.25466713631560406,-0.2410958904109589,Rep (McCain),Rep (Romney),3
georgia,lowndes,21085,17405,0,38490,21176,17118,316,38610,104916,-0.09560924915562484,-0.1059696035932522,Rep (McCain),Rep (Romney),9
georgia,terrell,1888,2497,0,4385,1834,2544,20,4398,9647,0.1388825541619156,0.16217450890817725,Dem (Obama),Dem (Obama),3
georgia,quitman,509,597,0,1106,510,612,6,1128,2528,0.07956600361663653,0.09090909090909091,Dem (Obama),Dem (Obama),1
georgia,appling,5083,1843,0,6926,5231,1756,92,7079,18050,-0.4678024833958995,-0.49735222556175757,Rep (McCain),Rep (Romney),4
georgia,whitfield,19216,8158,0,27374,19290,7193,345,26828,99910,-0.4039599620077446,-0.45678359702450627,Rep (McCain),Rep (Romney),9
georgia,turner,2096,1427,0,3523,2027,1508,21,3556,9025,-0.18989497587283566,-0.1468175388967468,Rep (McCain),Rep (Romney),2
georgia,screven,3419,3011,0,6430,3285,2769,39,6093,14799,-0.06345256609642301,-0.08523290386521308,Rep (McCain),Rep (Romney),4
georgia,brooks,3500,2658,0,6158,3522,3101,48,6671,16338,-0.13673270542383892,-0.06356635965574513,Rep (McCain),Rep (Romney),4
georgia,forsyth,59123,15383,0,74506,65853,14544,1201,81598,163885,-0.5870668134110004,-0.6381954550542931,Rep (McCain),Rep (Romney),9
georgia,benhill,3413,2589,0,6002,3395,2508,44,5947,17631,-0.1372875708097301,-0.15026257834999154,Rep (McCain),Rep (Romney),4
georgia,dekalb,65476,253675,0,319151,64308,237704,3287,305299,685371,0.5896863866946994,0.5741361270413096,Dem (Obama),Dem (Obama),10
georgia,henry,47115,40527,0,87642,46299,43374,796,90469,193717,-0.0751694393099199,-0.03261851393396006,Rep (McCain),Rep (Romney),9
georgia,rockdale,16860,20421,0,37281,15671,21878,330,37879,83135,0.09551782409270138,0.16530400276971424,Dem (Obama),Dem (Obama),8
georgia,oconee,12110,4821,0,16931,12222,4140,281,16643,31508,-0.430512078436005,-0.49394939493949397,Rep (McCain),Rep (Romney),6
georgia,gordon,13068,4247,0,17315,13174,3436,247,16857,54059,-0.5094426797574357,-0.5862733293196869,Rep (McCain),Rep (Romney),8
georgia,miller,1897,809,0,2706,1904,848,18,2770,6128,-0.402069475240207,-0.38372093023255816,Rep (McCain),Rep (Romney),2
georgia,gilmer,8400,2607,0,11007,8920,1955,133,11008,28076,-0.5263014445352957,-0.6404597701149425,Rep (McCain),Rep (Romney),6
georgia,jefferson,3060,4138,0,7198,2992,4238,38,7268,16919,0.14976382328424562,0.1723374827109267,Dem (Obama),Dem (Obama),4
georgia,elbert,4854,3353,0,8207,4857,3179,103,8139,20421,-0.18289265261362253,-0.20881035340965654,Rep (McCain),Rep (Romney),5
georgia,pulaski,2549,1370,0,3919,2444,1219,18,3681,11632,-0.30084205154376115,-0.33442533442533445,Rep (McCain),Rep (Romney),3
georgia,dawson,7701,1512,0,9213,8843,1241,150,10234,21758,-0.6717681536958645,-0.7538675128917096,Rep (McCain),Rep (Romney),5
georgia,floyd,23044,10641,0,33685,22636,9595,454,32685,95810,-0.3682054326851714,-0.4046104681828054,Rep (McCain),Rep (Romney),9
georgia,glynn,20460,12652,0,33112,20853,11922,279,33054,77632,-0.2358057501812032,-0.2724942791762014,Rep (McCain),Rep (Romney),8
georgia,jeffersondavis,3847,1350,0,5197,3994,1271,65,5330,14558,-0.48046950163555896,-0.5171889838556505,Rep (McCain),Rep (Romney),4
georgia,clarke,15309,29513,0,44822,13804,25386,948,40138,115070,0.3168979518986212,0.2955345751467211,Dem (Obama),Dem (Obama),9
georgia,coffee,8863,4805,0,13668,9242,5048,144,14434,41647,-0.29689786362306114,-0.2934919524142757,Rep (McCain),Rep (Romney),7
georgia,wayne,7601,2858,0,10459,7553,2594,111,10258,29705,-0.45348503681040253,-0.48871587661377747,Rep (McCain),Rep (Romney),6
georgia,baldwin,7818,8575,0,16393,7585,8469,160,16214,46905,0.04617824681266394,0.055064158465180015,Dem (Obama),Dem (Obama),7
georgia,hall,44913,14433,0,59346,45918,12489,834,59241,175001,-0.51359822060459,-0.5723457804715189,Rep (McCain),Rep (Romney),9
georgia,schley,1248,477,0,1725,1286,448,14,1748,4755,-0.4469565217391304,-0.48327566320645904,Rep (McCain),Rep (Romney),1
georgia,chatham,46801,62693,0,109494,47083,60077,1107,108267,256428,0.14514037298847426,0.12125793206420306,Dem (Obama),Dem (Obama),10
georgia,montgomery,2521,1043,0,3564,2662,1135,34,3831,9138,-0.41470258136924804,-0.40215959968396103,Rep (McCain),Rep (Romney),2
georgia,franklin,6054,1910,0,7964,6112,1499,146,7757,22121,-0.5203415369161225,-0.6060964393640783,Rep (McCain),Rep (Romney),5
georgia,walker,17101,6094,0,23195,16245,5269,365,21879,67845,-0.4745419271394697,-0.5101794180533606,Rep (McCain),Rep (Romney),8
georgia,meriwether,4980,4455,0,9435,4855,4328,76,9259,22425,-0.05564387917329094,-0.05738865294566046,Rep (McCain),Rep (Romney),5
georgia,twiggs,2086,2400,0,4486,1905,2269,25,4199,9385,0.06999554168524298,0.08720651653090561,Dem (Obama),Dem (Obama),3
georgia,bleckley,3652,1295,0,4947,3586,1266,51,4903,12937,-0.47645037396401857,-0.47815333882934874,Rep (McCain),Rep (Romney),3
georgia,upson,7282,4050,0,11332,7229,3955,73,11257,27308,-0.28521002470878926,-0.2927396280400572,Rep (McCain),Rep (Romney),6
georgia,newton,20331,20825,0,41156,20979,21844,393,43216,96833,0.012003110117601322,0.02019942554234874,Dem (Obama),Dem (Obama),9
georgia,clinch,1678,987,0,2665,1598,852,22,2472,6841,-0.2592870544090056,-0.30448979591836733,Rep (McCain),Rep (Romney),2
georgia,walton,27239,8457,0,35696,29018,8139,413,37570,81491,-0.5261653966831017,-0.5619129639098959,Rep (McCain),Rep (Romney),8
georgia,wilkinson,2349,2296,0,4645,2245,2180,23,4448,9685,-0.011410118406889129,-0.014689265536723164,Rep (McCain),Rep (Romney),3
georgia,talbot,1300,2367,0,3667,1202,2264,24,3490,6920,0.29097354785928553,0.3064050778995961,Dem (Obama),Dem (Obama),2
georgia,polk,9843,4043,0,13886,9798,3608,174,13580,41095,-0.41768687887080513,-0.46173355214083245,Rep (McCain),Rep (Romney),7
georgia,dade,4698,1608,0,6306,4458,1404,135,5997,16595,-0.4900095147478592,-0.5209825997952917,Rep (McCain),Rep (Romney),4
georgia,dooly,1979,2118,0,4097,1983,2278,28,4289,14283,0.03392726385159873,0.06923257451302511,Dem (Obama),Dem (Obama),4
georgia,hancock,792,3526,0,4318,764,3301,11,4076,9649,0.6331635016211209,0.6241082410824108,Dem (Obama),Dem (Obama),3
georgia,chattahoochee,803,827,0,1630,732,726,25,1483,11702,0.014723926380368098,-0.00411522633744856,Dem (Obama),Rep (Romney),3
georgia,harris,10645,4179,0,14824,11193,4141,145,15479,30807,-0.436184565569347,-0.45989304812834225,Rep (McCain),Rep (Romney),6
georgia,hart,6536,3363,0,9899,6516,2869,116,9501,25024,-0.32053742802303264,-0.38859882791688866,Rep (McCain),Rep (Romney),5
georgia,jones,7748,4551,0,12299,7740,4272,87,12099,28292,-0.2599398325067079,-0.2887112887112887,Rep (McCain),Rep (Romney),6
georgia,worth,5777,2540,0,8317,5864,2486,60,8410,21712,-0.3892028375616208,-0.4045508982035928,Rep (McCain),Rep (Romney),5
georgia,greene,4528,3329,0,7857,5067,3195,51,8313,15844,-0.15260277459590174,-0.22657952069716775,Rep (McCain),Rep (Romney),4
georgia,marion,1767,1380,0,3147,1731,1411,25,3167,8403,-0.12297426120114395,-0.10184595798854233,Rep (McCain),Rep (Romney),2
georgia,candler,2285,1207,0,3492,2344,1155,27,3526,10715,-0.3087056128293242,-0.33981137467847955,Rep (McCain),Rep (Romney),3
georgia,tattnall,4728,1932,0,6660,4702,1894,62,6658,24263,-0.4198198198198198,-0.4257125530624621,Rep (McCain),Rep (Romney),5
georgia,mcintosh,3280,2897,0,6177,3405,2860,68,6333,13817,-0.06200420916302412,-0.08699122106943336,Rep (McCain),Rep (Romney),3
georgia,calhoun,852,1322,0,2174,883,1297,7,2187,6488,0.21619135234590617,0.18990825688073396,Dem (Obama),Dem (Obama),2
georgia,treutlen,1816,1108,0,2924,1646,1068,24,2738,6835,-0.2421340629274966,-0.21296978629329402,Rep (McCain),Rep (Romney),2
georgia,camden,10351,6302,0,16653,11318,6358,262,17938,49293,-0.24313937428691526,-0.28060647205250056,Rep (McCain),Rep (Romney),7
georgia,burke,4342,5231,0,9573,4298,5403,72,9773,23083,0.09286535046484906,0.11390578290897846,Dem (Obama),Dem (Obama),5
georgia,carroll,28612,14308,0,42920,28249,12635,561,41445,109227,-0.33327120223671947,-0.3819097935622737,Rep (McCain),Rep (Romney),9
georgia,taylor,2019,1533,0,3552,1948,1571,18,3537,8875,-0.13682432432432431,-0.10713270815572606,Rep (McCain),Rep (Romney),2
georgia,houston,33355,22032,0,55387,34631,22643,638,57912,134880,-0.20443425352519545,-0.20930963438907707,Rep (McCain),Rep (Romney),9
georgia,taliaferro,339,643,0,982,321,636,4,961,2041,0.3095723014256619,0.329153605015674,Dem (Obama),Dem (Obama),1
georgia,washington,4215,4598,0,8813,4033,4705,58,8796,21112,0.043458527175763075,0.07690547035934997,Dem (Obama),Dem (Obama),5
georgia,mitchell,4199,3872,0,8071,4153,4081,39,8273,23697,-0.04051542559781935,-0.008744231236337139,Rep (McCain),Rep (Romney),5
georgia,irwin,2590,1186,0,3776,2519,1134,30,3683,9642,-0.3718220338983051,-0.37914043252121543,Rep (McCain),Rep (Romney),3
georgia,sumter,5713,6444,0,12157,5372,6370,78,11820,32865,0.06012996627457432,0.08499403849429399,Dem (Obama),Dem (Obama),6
georgia,paulding,39148,17201,0,56349,40771,15779,704,57254,134875,-0.3894833981082184,-0.44194518125552607,Rep (McCain),Rep (Romney),9
georgia,chattooga,5564,2591,0,8155,5434,2220,137,7791,25985,-0.3645616186388719,-0.41991115756467207,Rep (McCain),Rep (Romney),6
georgia,jasper,3913,1932,0,5845,4121,1839,50,6010,13695,-0.3389221556886228,-0.38288590604026845,Rep (McCain),Rep (Romney),3
georgia,murray,8180,3023,0,11203,8439,2542,228,11209,39925,-0.46032312773364276,-0.5370184864766415,Rep (McCain),Rep (Romney),7
georgia,wilkes,2705,2306,0,5011,2628,2080,38,4746,10580,-0.07962482538415486,-0.11639762107051826,Rep (McCain),Rep (Romney),3
georgia,early,2709,2602,0,5311,2556,2762,31,5349,11286,-0.020146864997175672,0.03873636705528394,Rep (McCain),Dem (Obama),3
georgia,thomas,10636,7709,0,18345,11153,7651,139,18943,44451,-0.15955301171981467,-0.1862369708572644,Rep (McCain),Rep (Romney),7
georgia,johnson,2426,1198,0,3624,2440,1305,27,3772,9967,-0.33885209713024284,-0.3030707610146863,Rep (McCain),Rep (Romney),3
georgia,fayette,38453,20272,0,58725,38046,19703,724,58473,105344,-0.3095955725840783,-0.31763320576979687,Rep (McCain),Rep (Romney),9
georgia,heard,3126,1040,0,4166,3155,947,60,4162,11720,-0.500720115218435,-0.538274012676743,Rep (McCain),Rep (Romney),3
georgia,seminole,2315,1657,0,3972,2244,1475,46,3765,8797,-0.16565961732124873,-0.20677601505781124,Rep (McCain),Rep (Romney),2
georgia,spalding,14875,10132,0,25007,14901,9884,272,25057,63304,-0.18966689326988442,-0.20242081904377648,Rep (McCain),Rep (Romney),8
georgia,stewart,783,1305,0,2088,740,1307,8,2055,5831,0.25,0.27699071812408405,Dem (Obama),Dem (Obama),2
georgia,union,8007,2486,0,10493,8771,2137,164,11072,21083,-0.5261602973410845,-0.6081774844151082,Rep (McCain),Rep (Romney),5
georgia,lincoln,2728,1649,0,4377,2806,1586,33,4425,8111,-0.24651587845556316,-0.2777777777777778,Rep (McCain),Rep (Romney),2
georgia,mcduffie,5400,3989,0,9389,5475,4041,69,9585,21719,-0.1502822451805304,-0.15069356872635561,Rep (McCain),Rep (Romney),5
georgia,jenkins,1935,1480,0,3415,1884,1487,15,3386,8400,-0.13323572474377746,-0.11776920795016316,Rep (McCain),Rep (Romney),2
idaho,power,1754,1027,0,2781,1870,982,51,2903,7633,-0.2614167565623876,-0.31136044880785413,Rep (McCain),Rep (Romney),2
idaho,idaho,5895,1935,0,7830,5821,1722,206,7749,15947,-0.5057471264367817,-0.543417738300411,Rep (McCain),Rep (Romney),4
idaho,cassia,6240,1305,0,7545,7150,1093,144,8387,22109,-0.6540755467196819,-0.7348052893364067,Rep (McCain),Rep (Romney),5
idaho,butte,1056,318,0,1374,1001,258,27,1286,2842,-0.537117903930131,-0.5901509134233519,Rep (McCain),Rep (Romney),1
idaho,bonneville,29324,11415,0,40739,32336,9929,1037,43302,100213,-0.4396033285058543,-0.5301549745652431,Rep (McCain),Rep (Romney),9
idaho,teton,2263,2302,0,4565,2458,1926,139,4523,9413,0.008543263964950712,-0.12135036496350365,Dem (Obama),Rep (Romney),3
idaho,elmore,5571,2523,0,8094,5227,2513,261,8001,26669,-0.3765752409191994,-0.35064599483204134,Rep (McCain),Rep (Romney),6
idaho,bonner,11145,7840,0,18985,11367,6500,669,18536,40711,-0.17408480379246774,-0.27240163429786757,Rep (McCain),Rep (Romney),7
idaho,owyhee,3024,944,0,3968,2794,833,96,3723,11389,-0.5241935483870968,-0.5406672180865729,Rep (McCain),Rep (Romney),3
idaho,payette,5988,2415,0,8403,6004,2271,220,8495,22451,-0.42520528382720457,-0.4511178247734139,Rep (McCain),Rep (Romney),5
idaho,jerome,4897,1794,0,6691,4804,1699,178,6681,21282,-0.4637572859064415,-0.4774719360295248,Rep (McCain),Rep (Romney),5
idaho,caribou,2656,553,0,3209,2608,385,57,3050,6900,-0.6553443440324088,-0.7427330437687939,Rep (McCain),Rep (Romney),2
idaho,twinfalls,19032,8621,0,27653,19773,7541,828,28142,74929,-0.3764871804144216,-0.4478289521856923,Rep (McCain),Rep (Romney),8
idaho,lewis,1275,479,0,1754,1173,396,43,1612,3761,-0.45381984036488027,-0.49521988527724664,Rep (McCain),Rep (Romney),1
idaho,canyon,42752,20147,0,62899,44369,19866,1855,66090,182723,-0.35938568180734193,-0.38145870631275786,Rep (McCain),Rep (Romney),9
idaho,boise,2433,1240,0,3673,2284,953,108,3345,7122,-0.32480261366730195,-0.4111831943157244,Rep (McCain),Rep (Romney),2
idaho,nezperce,10357,7123,0,17480,9967,6451,430,16848,38886,-0.18501144164759725,-0.21415519551711537,Rep (McCain),Rep (Romney),7
idaho,minidoka,3976,1137,0,5113,5442,1390,141,6973,19524,-0.5552513201642871,-0.5930913348946136,Rep (McCain),Rep (Romney),5
idaho,clearwater,2569,1211,0,3780,2541,1032,123,3696,8766,-0.3592592592592593,-0.42233417296389586,Rep (McCain),Rep (Romney),2
idaho,bannock,19356,14792,0,34148,21010,13214,1036,35260,80701,-0.13365350825817032,-0.22779336138382422,Rep (McCain),Rep (Romney),8
idaho,boundary,3098,1474,0,4572,3138,1225,181,4544,10792,-0.3552055993000875,-0.4384597753839102,Rep (McCain),Rep (Romney),3
idaho,benewah,2646,1407,0,4053,2596,1164,124,3884,9302,-0.30569948186528495,-0.38085106382978723,Rep (McCain),Rep (Romney),3
idaho,ada,92879,82023,0,174902,97471,77043,5847,180361,380718,-0.06206904437913803,-0.11705651122546042,Rep (McCain),Rep (Romney),10
idaho,camas,422,187,0,609,402,159,17,578,1216,-0.38587848932676516,-0.43315508021390375,Rep (McCain),Rep (Romney),1
idaho,adams,1515,728,0,2243,1413,577,70,2060,3942,-0.35086937137761925,-0.4201005025125628,Rep (McCain),Rep (Romney),1
idaho,valley,2750,2394,0,5144,2664,2095,160,4919,9846,-0.06920684292379471,-0.11956293338936752,Rep (McCain),Rep (Romney),3
idaho,shoshone,2953,2521,0,5474,2699,2277,172,5148,12917,-0.07891852393131166,-0.08480707395498392,Rep (McCain),Rep (Romney),3
idaho,blaine,3439,6947,0,10386,3939,5992,263,10194,21329,0.3377623724244175,0.20672641224448696,Dem (Obama),Dem (Obama),5
idaho,kootenai,38387,22120,0,60507,39347,18824,1593,59764,134851,-0.2688449270332358,-0.35280466211686234,Rep (McCain),Rep (Romney),9
idaho,fremont,4700,1065,0,5765,4907,810,85,5802,13062,-0.6305290546400694,-0.7166345985656813,Rep (McCain),Rep (Romney),3
idaho,washington,3168,1241,0,4409,3128,1104,98,4330,10105,-0.43706055794964843,-0.4782608695652174,Rep (McCain),Rep (Romney),3
idaho,latah,7984,9191,0,17175,7589,8306,864,16759,36645,0.07027656477438136,0.04510852469329978,Dem (Obama),Dem (Obama),7
idaho,bingham,12230,4424,0,16654,13440,3822,341,17603,44496,-0.46871622433049115,-0.5571776155717761,Rep (McCain),Rep (Romney),7
idaho,jefferson,8540,1641,0,10181,9895,1303,183,11381,24523,-0.6776348099400845,-0.7672798714056082,Rep (McCain),Rep (Romney),5
idaho,lemhi,2938,796,0,3734,3029,960,120,4109,7861,-0.5736475629351901,-0.5186763599899724,Rep (McCain),Rep (Romney),2
idaho,oneida,1724,381,0,2105,1838,217,34,2089,4212,-0.6380047505938242,-0.7888077858880779,Rep (McCain),Rep (Romney),1
idaho,gooding,3764,1485,0,5249,3696,1287,135,5118,15140,-0.4341779386549819,-0.48344370860927155,Rep (McCain),Rep (Romney),4
idaho,bearlake,2377,502,0,2879,2489,302,31,2822,6026,-0.6512678013199027,-0.7835901110713006,Rep (McCain),Rep (Romney),2
idaho,madison,11120,1625,0,12745,13445,832,135,14412,36413,-0.7449980384464496,-0.8834489038313371,Rep (McCain),Rep (Romney),6
idaho,franklin,4231,599,0,4830,5195,325,80,5600,12497,-0.7519668737060041,-0.8822463768115942,Rep (McCain),Rep (Romney),3
idaho,custer,1704,620,0,2324,1744,530,78,2352,4277,-0.4664371772805508,-0.5338610378188214,Rep (McCain),Rep (Romney),1
idaho,lincoln,967,497,0,1464,1141,429,52,1622,5021,-0.32103825136612024,-0.4535031847133758,Rep (McCain),Rep (Romney),1
idaho,gem,5585,2166,0,7751,5311,1957,222,7490,16778,-0.4411043736292091,-0.46147495872317007,Rep (McCain),Rep (Romney),4
idaho,clark,305,64,0,369,235,66,27,328,857,-0.6531165311653117,-0.5614617940199336,Rep (McCain),Rep (Romney),1
illinois,rockisland,25338,42175,0,67513,24888,39081,911,64880,147524,0.24938900656169924,0.2218730947802842,Dem (Obama),Dem (Obama),9
illinois,richland,4320,3177,0,7497,4750,2360,164,7274,16166,-0.1524609843937575,-0.3361462728551336,Rep (McCain),Rep (Romney),4
illinois,kane,84223,105592,0,189815,89502,91120,3009,183631,502628,0.11257803650923268,0.00895793424942698,Dem (Obama),Dem (Obama),10
illinois,pope,1339,842,0,2181,1511,649,59,2219,4426,-0.22787712058688675,-0.3990740740740741,Rep (McCain),Rep (Romney),1
illinois,winnebago,53806,69903,0,123709,53722,60334,2045,116101,293972,0.1301198781010274,0.05797152276074911,Dem (Obama),Dem (Obama),10
illinois,kendall,20675,23529,0,44204,23076,21219,747,45042,105602,0.0645642928241788,-0.04192346766000677,Dem (Obama),Rep (Romney),9
illinois,randolph,7536,7387,0,14923,8284,5753,343,14380,33567,-0.009984587549420358,-0.18030918287383343,Rep (McCain),Rep (Romney),6
illinois,grundy,9144,9134,0,18278,11198,9319,439,20956,48744,-5.47105810263705e-4,-0.09158259004727787,Rep (McCain),Rep (Romney),7
illinois,jackson,9665,15199,0,24864,9130,11306,754,21190,59864,0.22257078507078507,0.10647876296731258,Dem (Obama),Dem (Obama),8
illinois,monroe,9870,7943,0,17813,10879,6205,323,17407,32431,-0.10817941952506596,-0.2735893233434793,Rep (McCain),Rep (Romney),6
illinois,dupage,182860,227416,0,410276,193333,197411,6429,397173,911481,0.10860006434692743,0.010436500624449768,Dem (Obama),Dem (Obama),10
illinois,stephenson,9686,11010,0,20696,8742,7954,333,17029,47791,0.06397371472748357,-0.04719693339722089,Dem (Obama),Rep (Romney),7
illinois,morgan,7585,7458,0,15043,7962,5792,317,14071,35755,-0.008442464933856279,-0.1577722844263487,Rep (McCain),Rep (Romney),6
illinois,putnam,1376,1900,0,3276,1500,1558,74,3132,5982,0.15995115995115994,0.01896664486592544,Dem (Obama),Dem (Obama),2
illinois,madison,57059,68836,0,125895,60481,58813,2909,122203,268005,0.09354620914253942,-0.013982262309923383,Dem (Obama),Rep (Romney),10
illinois,knox,9396,14165,0,23561,9133,12993,391,22517,52932,0.2024107635499342,0.1744553918466962,Dem (Obama),Dem (Obama),8
illinois,mclean,36657,37551,0,74208,39638,31590,1528,72756,166706,0.012047218628719275,-0.112989273881058,Dem (Obama),Rep (Romney),9
illinois,brown,1541,985,0,2526,1511,787,64,2362,6897,-0.220110847189232,-0.31505657093124456,Rep (McCain),Rep (Romney),2
illinois,livingston,9180,6184,0,15364,9745,5014,260,15019,39010,-0.1950013017443374,-0.32055017277593334,Rep (McCain),Rep (Romney),7
illinois,lake,85284,111051,0,196335,128609,151552,3871,284032,697179,0.131239972495989,0.08189219770060786,Dem (Obama),Dem (Obama),10
illinois,douglas,5001,3226,0,8227,5331,2426,132,7889,20012,-0.21575300838701836,-0.3745004512053629,Rep (McCain),Rep (Romney),5
illinois,shelby,6390,4236,0,10626,6837,3336,210,10383,22362,-0.20271033314511575,-0.3441462695370097,Rep (McCain),Rep (Romney),5
illinois,jersey,5320,5036,0,10356,6032,3656,252,9940,22932,-0.02742371572035535,-0.24525185796862098,Rep (McCain),Rep (Romney),5
illinois,lee,8243,7757,0,16000,8046,6932,297,15275,36100,-0.030375,-0.0743757511016157,Rep (McCain),Rep (Romney),6
illinois,macoupin,9879,12071,0,21950,10909,9440,598,20947,47980,0.0998633257403189,-0.07219027962062018,Dem (Obama),Rep (Romney),7
illinois,edgar,4393,3737,0,8130,5125,2563,122,7810,18776,-0.08068880688806888,-0.3332466181061394,Rep (McCain),Rep (Romney),4
illinois,pike,4451,3021,0,7472,4853,2276,146,7275,16580,-0.1913811563169165,-0.3614812736709216,Rep (McCain),Rep (Romney),4
illinois,cook,477038,1582973,0,2060011,479204,1439123,26074,1944401,5172848,0.536858783763776,0.500393832751142,Dem (Obama),Dem (Obama),10
illinois,henderson,1540,2213,0,3753,1538,1977,48,3563,7462,0.1793232081001865,0.12489331436699858,Dem (Obama),Dem (Obama),2
illinois,gallatin,1211,1587,0,2798,1492,1028,49,2569,5773,0.1343817012151537,-0.18412698412698414,Dem (Obama),Rep (Romney),2
illinois,jodaviess,5163,6392,0,11555,5529,5660,222,11411,22728,0.10636088273474686,0.01170792742872464,Dem (Obama),Dem (Obama),5
illinois,macon,24901,25419,0,50320,25249,22688,805,48742,110719,0.010294117647058823,-0.05342428604209692,Dem (Obama),Rep (Romney),9
illinois,clay,3924,2423,0,6347,4184,1581,134,5899,13927,-0.23648968016385694,-0.4515177797051171,Rep (McCain),Rep (Romney),4
illinois,adams,18592,11700,0,30292,20371,9627,540,30538,67030,-0.22751881684933314,-0.3581572104806987,Rep (McCain),Rep (Romney),8
illinois,lasalle,21855,27415,0,49270,23207,23023,916,47146,113789,0.1128475745889994,-0.003980099502487562,Dem (Obama),Rep (Romney),9
illinois,dewitt,4345,3299,0,7644,4576,2598,164,7338,16672,-0.1368393511250654,-0.2757178700864232,Rep (McCain),Rep (Romney),4
illinois,effingham,11313,5256,0,16569,12491,3855,249,16595,34232,-0.36556219445953286,-0.5283249724703292,Rep (McCain),Rep (Romney),6
illinois,bureau,7902,8872,0,16774,8151,8118,330,16599,35083,0.057827590318349824,-0.002028397565922921,Dem (Obama),Rep (Romney),6
illinois,cass,2617,2690,0,5307,2707,2050,101,4858,13648,0.013755417373280572,-0.138112255623292,Dem (Obama),Rep (Romney),3
illinois,fulton,6244,9722,0,15966,6622,8324,391,15337,37205,0.21783790554929225,0.11387662250769437,Dem (Obama),Dem (Obama),7
illinois,kankakee,22508,24719,0,47227,23115,21574,763,45452,112100,0.04681643974844898,-0.034482758620689655,Dem (Obama),Rep (Romney),9
illinois,stark,1513,1357,0,2870,1527,1095,39,2661,6086,-0.05435540069686411,-0.16475972540045766,Rep (McCain),Rep (Romney),2
illinois,whiteside,10867,15587,0,26454,8676,12393,423,21492,58750,0.178422922809405,0.17642033319094405,Dem (Obama),Dem (Obama),8
illinois,warren,3637,4286,0,7923,3460,3893,123,7476,17745,0.081913416635112965,0.0588875288997688,Dem (Obama),Dem (Obama),4
illinois,will,119049,154691,0,273740,118366,127522,3820,249708,667977,0.13020384306276028,0.03723646538261322,Dem (Obama),Dem (Obama),10
illinois,edwards,2136,1140,0,3276,2402,754,69,3225,6707,-0.304029304029304,-0.5221799746514575,Rep (McCain),Rep (Romney),2
illinois,ford,4075,2226,0,6301,4225,1654,121,6000,14113,-0.2934454848436756,-0.43731927198503145,Rep (McCain),Rep (Romney),4
illinois,peoria,33018,44396,0,77414,36617,40050,1393,78060,185108,0.14697599917327614,0.04477806618232095,Dem (Obama),Dem (Obama),9
illinois,perry,5077,4697,0,9774,5497,3813,223,9533,22488,-0.03887865766318805,-0.18088077336197636,Rep (McCain),Rep (Romney),5
illinois,clark,4406,3737,0,8143,5138,2587,118,7843,16545,-0.08215645339555447,-0.3302265372168285,Rep (McCain),Rep (Romney),4
illinois,white,3985,3315,0,7300,4729,2187,143,7059,14800,-0.09178082191780822,-0.3675534991324465,Rep (McCain),Rep (Romney),4
illinois,piatt,4988,3856,0,8844,5412,3081,204,8697,16708,-0.127996381727725,-0.2744613210879548,Rep (McCain),Rep (Romney),4
illinois,scott,1453,1090,0,2543,1586,910,58,2554,5374,-0.14274478961856074,-0.2708333333333333,Rep (McCain),Rep (Romney),2
illinois,crawford,5067,3877,0,8944,5577,2855,166,8598,19864,-0.13305008944543828,-0.3228178368121442,Rep (McCain),Rep (Romney),5
illinois,williamson,17351,12893,0,30244,17880,10622,577,29079,65579,-0.14740113741568575,-0.2546487965756789,Rep (McCain),Rep (Romney),8
illinois,alexander,1692,2189,0,3881,1485,1961,49,3495,8449,0.1280597784076269,0.13813116656993615,Dem (Obama),Dem (Obama),2
illinois,coles,10962,11704,0,22666,11623,9252,463,21338,53568,0.032736256948733784,-0.11358083832335329,Dem (Obama),Rep (Romney),8
illinois,ogle,13131,11247,0,24378,13409,9504,429,23342,53578,-0.07728279596357371,-0.17042726836293806,Rep (McCain),Rep (Romney),8
illinois,dekalb,18260,25765,0,44025,18906,21171,943,41020,104026,0.17047132311186824,0.05651620630286698,Dem (Obama),Dem (Obama),9
illinois,logan,7424,5245,0,12669,7835,3974,228,12037,30440,-0.1719946325676849,-0.32695401812177155,Rep (McCain),Rep (Romney),6
illinois,menard,3672,2704,0,6376,3944,2095,103,6142,12702,-0.15181932245922208,-0.3061765192912734,Rep (McCain),Rep (Romney),3
illinois,henry,11247,13177,0,24424,11564,12316,399,24279,50477,0.07902063544055028,0.03149078726968174,Dem (Obama),Dem (Obama),7
illinois,mason,3139,3540,0,6679,3265,2867,140,6272,14921,0.06003892798323102,-0.06490541422048271,Dem (Obama),Rep (Romney),4
illinois,clinton,9348,7653,0,17001,10493,5577,324,16394,37395,-0.09970001764602082,-0.3059116365899191,Rep (McCain),Rep (Romney),7
illinois,hardin,1330,892,0,2222,1535,742,53,2330,4402,-0.19711971197119713,-0.3482652613087396,Rep (McCain),Rep (Romney),1
illinois,jefferson,9293,7460,0,16753,9805,6080,418,16303,39202,-0.10941323941980541,-0.23449795404469626,Rep (McCain),Rep (Romney),7
illinois,mercer,3830,4885,0,8715,3874,4503,148,8525,16551,0.12105565117613311,0.07508654649635908,Dem (Obama),Dem (Obama),4
illinois,hamilton,2353,1794,0,4147,2566,1266,103,3935,8453,-0.13479623824451412,-0.33924843423799583,Rep (McCain),Rep (Romney),2
illinois,pulaski,1592,1636,0,3228,1562,1389,50,3001,6262,0.013630731102850062,-0.05862419518807184,Dem (Obama),Rep (Romney),2
illinois,sangamon,46857,51176,0,98033,50131,41961,1940,94032,195288,0.04405659318800812,-0.08871563219389306,Dem (Obama),Rep (Romney),9
illinois,mcdonough,6047,6780,0,12827,6142,5957,340,12439,32730,0.05714508458719888,-0.01529051987767584,Dem (Obama),Rep (Romney),6
illinois,cumberland,3155,2052,0,5207,3506,1640,144,5290,11073,-0.21183022853850586,-0.3626117372716673,Rep (McCain),Rep (Romney),3
illinois,tazewell,33203,29335,0,62538,35266,24385,1252,60903,133863,-0.0618503949598644,-0.18241102412365257,Rep (McCain),Rep (Romney),9
illinois,wayne,5381,2545,0,7926,5984,1514,178,7676,16846,-0.35780974009588695,-0.5961589757268605,Rep (McCain),Rep (Romney),4
illinois,franklin,9390,8873,0,18263,10253,7245,393,17891,39528,-0.028308602091660733,-0.17190536061264144,Rep (McCain),Rep (Romney),7
illinois,montgomery,6141,6486,0,12627,6771,5053,296,12120,30230,0.0273224043715847,-0.145297699594046,Dem (Obama),Rep (Romney),6
illinois,vermilion,16046,16228,0,32274,14888,10773,492,26153,82033,0.005639214228171283,-0.160360079498071,Dem (Obama),Rep (Romney),8
illinois,christian,7869,6912,0,14781,8873,5487,322,14682,34936,-0.06474528110412016,-0.23579387186629527,Rep (McCain),Rep (Romney),6
illinois,lawrence,3401,3013,0,6414,3853,2010,121,5984,16849,-0.060492672279388836,-0.3143441923929729,Rep (McCain),Rep (Romney),4
illinois,boone,10396,11324,0,21720,11084,9868,381,21333,53567,0.0427255985267035,-0.05803741886216113,Dem (Obama),Rep (Romney),8
illinois,hancock,4778,3753,0,8531,4810,3246,173,8229,19227,-0.12015004102684328,-0.19414101290963257,Rep (McCain),Rep (Romney),5
illinois,schuyler,1830,1896,0,3726,2062,1726,94,3882,7527,0.017713365539452495,-0.08870116156282999,Dem (Obama),Rep (Romney),2
illinois,greene,3048,2617,0,5665,3446,2023,145,5614,13983,-0.07608120035304501,-0.2601938197110989,Rep (McCain),Rep (Romney),4
illinois,marion,8687,8334,0,17021,9229,6210,289,15728,39722,-0.020739087010163915,-0.19554375283373276,Rep (McCain),Rep (Romney),7
illinois,mchenry,64595,71976,0,136571,71488,59691,2410,133589,306050,0.0540451486772448,-0.08993055290862105,Dem (Obama),Rep (Romney),10
illinois,bond,3938,3832,0,7770,4091,3016,209,7316,17904,-0.013642213642213642,-0.15125932179541296,Rep (McCain),Rep (Romney),4
illinois,calhoun,1221,1421,0,2642,1439,1079,56,2574,5118,0.0757002271006813,-0.14297061159650518,Dem (Obama),Rep (Romney),1
illinois,champaign,33748,48351,0,82099,35086,40378,2156,77620,197867,0.17787061961777853,0.0701261528675925,Dem (Obama),Dem (Obama),10
illinois,marshall,3142,3078,0,6220,3287,2452,103,5842,12763,-0.010289389067524116,-0.1454957309635825,Rep (McCain),Rep (Romney),3
illinois,wabash,3252,2462,0,5714,3473,1588,66,5127,12141,-0.1382569128456423,-0.3724560363564513,Rep (McCain),Rep (Romney),3
illinois,carroll,3589,3956,0,7545,3551,3658,161,7370,15615,0.0486414844267727,0.014842557913718963,Dem (Obama),Dem (Obama),4
illinois,moultrie,3466,2663,0,6129,3781,2142,129,6052,14723,-0.13101647903410019,-0.27671787945297993,Rep (McCain),Rep (Romney),4
illinois,woodford,12137,6969,0,19106,12947,5564,337,18848,38226,-0.27049094525280015,-0.3988439306358382,Rep (McCain),Rep (Romney),7
illinois,washington,4468,3338,0,7806,4787,2448,163,7398,14841,-0.14476044068665128,-0.3232895646164478,Rep (McCain),Rep (Romney),4
illinois,saline,6096,5082,0,11178,6803,3697,213,10713,25171,-0.09071390230810521,-0.2958095238095238,Rep (McCain),Rep (Romney),5
illinois,jasper,2963,2063,0,5026,3511,1434,93,5038,9752,-0.17906884202148826,-0.42002022244691606,Rep (McCain),Rep (Romney),3
illinois,iroquois,8686,4640,0,13326,9115,3408,247,12770,30068,-0.3036169893441393,-0.4557214724906173,Rep (McCain),Rep (Romney),6
illinois,johnson,3138,1477,0,4615,3959,1571,136,5666,12710,-0.3599133261105092,-0.43182640144665463,Rep (McCain),Rep (Romney),3
illinois,fayette,5493,3963,0,9456,5950,2848,165,8963,22007,-0.1618020304568528,-0.3525801318481473,Rep (McCain),Rep (Romney),5
illinois,stclair,47005,77896,0,124901,49610,66749,2020,118379,266727,0.2473238805133666,0.14729415000128912,Dem (Obama),Dem (Obama),10
illinois,massac,4371,2693,0,7064,4278,2092,122,6492,15425,-0.23754246885617214,-0.343171114599686,Rep (McCain),Rep (Romney),4
illinois,union,4999,3916,0,8915,4951,3135,188,8274,17959,-0.12148065058889512,-0.22458570368538214,Rep (McCain),Rep (Romney),4
indiana,jay,4400,3746,0,8146,4643,3063,191,7897,21441,-0.08028480235698503,-0.20503503763301323,Rep (McCain),Rep (Romney),5
indiana,gibson,8449,6455,0,14904,9487,4928,303,14718,33386,-0.13378958668813742,-0.31626777662157474,Rep (McCain),Rep (Romney),6
indiana,blackford,2690,2677,0,5367,2710,1927,103,4740,12960,-0.002422209800633501,-0.16885917619150312,Rep (McCain),Rep (Romney),3
indiana,scott,4443,4268,0,8711,4539,3998,179,8716,24109,-0.020089541958443348,-0.0633712076841982,Rep (McCain),Rep (Romney),5
indiana,decatur,6443,3890,0,10333,7119,2941,243,10303,25584,-0.24707248620923256,-0.4153081510934394,Rep (McCain),Rep (Romney),5
indiana,vigo,18111,25023,0,43134,19368,19707,768,39843,107151,0.16024481847266658,0.008675623800383878,Dem (Obama),Dem (Obama),9
indiana,shelby,10330,6983,0,17313,10972,5357,414,16743,44237,-0.19332293652168892,-0.34386674015555146,Rep (McCain),Rep (Romney),7
indiana,delaware,20904,28356,0,49260,21231,22630,1063,44924,117344,0.151278928136419,0.03189621759649803,Dem (Obama),Dem (Obama),9
indiana,posey,6794,5820,0,12614,7427,4531,258,12216,26100,-0.07721579197716823,-0.24218096671684228,Rep (McCain),Rep (Romney),6
indiana,crawford,2393,2286,0,4679,2418,2040,128,4586,10825,-0.022868134216712972,-0.0847913862718708,Rep (McCain),Rep (Romney),3
indiana,wells,8503,4403,0,12906,9255,3434,233,12922,27744,-0.3176816984348365,-0.45874379383718183,Rep (McCain),Rep (Romney),6
indiana,hancock,21991,11869,0,33860,22750,9303,705,32758,68011,-0.29893679858239813,-0.4195239135182354,Rep (McCain),Rep (Romney),8
indiana,boone,16616,9744,0,26360,18807,8326,592,27725,54796,-0.2606980273141123,-0.3862823867615081,Rep (McCain),Rep (Romney),8
indiana,starke,4473,4778,0,9251,4738,3809,205,8752,23343,0.03296940871257161,-0.10869310869310869,Dem (Obama),Rep (Romney),5
indiana,spencer,4998,5037,0,10035,5515,4026,184,9725,20977,0.0038863976083707025,-0.15606330573315166,Dem (Obama),Rep (Romney),5
indiana,fountain,4151,3094,0,7245,4660,2233,210,7103,17329,-0.14589371980676327,-0.352096329609749,Rep (McCain),Rep (Romney),4
indiana,switzerland,1940,1638,0,3578,1872,1437,88,3397,10393,-0.08440469536053662,-0.1314596554850408,Rep (McCain),Rep (Romney),3
indiana,marion,131459,237275,0,368734,136131,215474,6140,357745,890976,0.2869710956949996,0.22565947583225496,Dem (Obama),Dem (Obama),10
indiana,greene,7689,5709,0,13398,8457,4340,304,13101,33084,-0.1477832512315271,-0.32171602719387354,Rep (McCain),Rep (Romney),6
indiana,daviess,7096,3369,0,10465,7638,2437,171,10246,31045,-0.35613951266125177,-0.516228287841191,Rep (McCain),Rep (Romney),6
indiana,pike,3221,2700,0,5921,3627,2125,172,5924,12955,-0.08799189326127344,-0.26112656467315715,Rep (McCain),Rep (Romney),3
indiana,kosciusko,20484,9229,0,29713,22553,6862,624,30039,76982,-0.37879042843199945,-0.5334353221145673,Rep (McCain),Rep (Romney),8
indiana,tippecanoe,29789,37709,0,67498,28708,26642,1346,56696,168635,0.11733680997955495,-0.03732610659439928,Dem (Obama),Rep (Romney),9
indiana,noble,9671,7063,0,16734,10680,5229,335,16244,47513,-0.15585036452730966,-0.3426362436356779,Rep (McCain),Rep (Romney),7
indiana,howard,20207,17803,0,38010,20284,15097,813,36194,83326,-0.06324651407524336,-0.14660410955032363,Rep (McCain),Rep (Romney),8
indiana,whitley,9122,5861,0,14983,10257,4420,328,15005,32991,-0.21764666622171794,-0.39769707705934454,Rep (McCain),Rep (Romney),6
indiana,grant,14726,11291,0,26017,15148,9589,521,25258,70176,-0.1320290579236653,-0.2247240975057606,Rep (McCain),Rep (Romney),8
indiana,parke,3900,2913,0,6813,4228,2106,170,6504,17394,-0.1448701012769705,-0.3350173665929902,Rep (McCain),Rep (Romney),4
indiana,steuben,7670,6283,0,13953,8542,4846,289,13677,34092,-0.0994051458467713,-0.27606812070510905,Rep (McCain),Rep (Romney),6
indiana,vermillion,3004,4002,0,7006,3426,2979,173,6578,16412,0.1424493291464459,-0.06978922716627635,Dem (Obama),Rep (Romney),4
indiana,elkhart,39344,31289,0,70633,42348,24376,1044,67768,196855,-0.11404017951948806,-0.26934836041004734,Rep (McCain),Rep (Romney),10
indiana,orange,4536,3390,0,7926,4615,2939,199,7753,19820,-0.1445874337623013,-0.22186920836642837,Rep (McCain),Rep (Romney),5
indiana,bartholomew,17061,13555,0,30616,18083,10622,608,29313,75855,-0.11451528612490201,-0.259919874586309,Rep (McCain),Rep (Romney),8
indiana,wabash,8238,5455,0,13693,8528,3929,245,12702,33225,-0.20324253268093187,-0.3691900136469455,Rep (McCain),Rep (Romney),6
indiana,vanderburgh,37449,39368,0,76817,39504,31659,1253,72416,178298,0.024981449418748455,-0.11023987184351419,Dem (Obama),Rep (Romney),9
indiana,marshall,10401,7880,0,18281,11260,6136,355,17751,46976,-0.13790274055029814,-0.2945504713727294,Rep (McCain),Rep (Romney),7
indiana,clay,6264,4954,0,11218,7065,3630,227,10922,26983,-0.11677660902121591,-0.3211781206171108,Rep (McCain),Rep (Romney),6
indiana,carroll,4845,3733,0,8578,4993,2631,169,7793,20135,-0.1296339473070646,-0.30981112277019934,Rep (McCain),Rep (Romney),5
indiana,stjoseph,48510,68708,0,117218,52575,56458,1611,110644,266522,0.1723114197478203,0.03561307127200022,Dem (Obama),Dem (Obama),10
indiana,randolph,5787,4839,0,10626,6218,3768,202,10188,26262,-0.08921513269339357,-0.24534348087322252,Rep (McCain),Rep (Romney),6
indiana,adams,8402,4928,0,13330,8936,3800,262,12998,34162,-0.26061515378844713,-0.40326633165829145,Rep (McCain),Rep (Romney),6
indiana,dekalb,9771,7169,0,16940,10586,5419,309,16314,41968,-0.15360094451003542,-0.32283661355826304,Rep (McCain),Rep (Romney),7
indiana,henry,10894,10058,0,20952,10836,7613,547,18996,48921,-0.03990072546773578,-0.1746978155997615,Rep (McCain),Rep (Romney),7
indiana,jackson,9852,7445,0,17297,10419,5838,447,16704,41902,-0.1391570792622998,-0.28178630743679645,Rep (McCain),Rep (Romney),7
indiana,washington,6512,4561,0,11073,6532,3909,284,10725,28226,-0.17619434660886843,-0.2512211473996744,Rep (McCain),Rep (Romney),6
indiana,rush,4270,3228,0,7498,4633,2221,172,7026,17568,-0.13897039210456122,-0.35191129267580973,Rep (McCain),Rep (Romney),4
indiana,warrick,16013,12329,0,28342,15350,8791,486,24627,58393,-0.12998376967045375,-0.27169545586346877,Rep (McCain),Rep (Romney),8
indiana,owen,4415,3570,0,7985,5062,2823,222,8107,21737,-0.1058234189104571,-0.2839568801521877,Rep (McCain),Rep (Romney),5
indiana,clinton,6915,5306,0,12221,6338,3307,234,9879,33270,-0.1316586204074953,-0.3142560912389839,Rep (McCain),Rep (Romney),6
indiana,monroe,21083,41332,0,62415,16254,22885,1061,40200,134442,0.32442521829688376,0.16942180433838372,Dem (Obama),Dem (Obama),9
indiana,miami,8305,5559,0,13864,8163,4220,375,12758,37307,-0.198066935949221,-0.3184204150851975,Rep (McCain),Rep (Romney),7
indiana,jefferson,7052,6255,0,13307,7096,5728,296,13120,32393,-0.05989328924626137,-0.10667498440424204,Rep (McCain),Rep (Romney),6
indiana,benton,2180,1563,0,3743,2329,1159,89,3577,8820,-0.16484103660165642,-0.33543577981651373,Rep (McCain),Rep (Romney),2
indiana,lagrange,5697,3659,0,9356,6227,2897,187,9311,36996,-0.2178281316802052,-0.3649715037264358,Rep (McCain),Rep (Romney),7
indiana,hamilton,78391,49691,0,128082,90740,43794,2269,136803,261244,-0.22407520182383162,-0.34895268110663474,Rep (McCain),Rep (Romney),10
indiana,fulton,5145,3700,0,8845,5315,2621,184,8120,20684,-0.16336913510457884,-0.3394657258064516,Rep (McCain),Rep (Romney),5
indiana,cass,8339,6995,0,15334,8432,5365,340,14137,39058,-0.08764836311464719,-0.22229470174675653,Rep (McCain),Rep (Romney),7
indiana,pulaski,3368,2466,0,5834,3366,1899,134,5399,13596,-0.15461090161124444,-0.27863247863247864,Rep (McCain),Rep (Romney),3
indiana,jasper,7669,5044,0,12713,7955,4672,264,12891,33055,-0.20648155431448123,-0.2599984160925002,Rep (McCain),Rep (Romney),6
indiana,dearborn,14886,7123,0,22009,15391,6527,434,22352,49580,-0.3527193420873279,-0.40441646135596315,Rep (McCain),Rep (Romney),7
indiana,porter,33796,39046,0,72842,34197,36950,1340,72487,162026,0.07207380357486065,0.038694533852446346,Dem (Obama),Dem (Obama),9
indiana,warren,2164,1753,0,3917,2377,1324,97,3798,8563,-0.10492724023487363,-0.2845176979194812,Rep (McCain),Rep (Romney),2
indiana,morgan,18105,10314,0,28419,19591,7969,691,28251,68654,-0.27414757732502903,-0.4216981132075472,Rep (McCain),Rep (Romney),8
indiana,floyd,19944,16248,0,36192,19868,14805,610,35283,73594,-0.10212201591511937,-0.14602139993655006,Rep (McCain),Rep (Romney),8
indiana,ripley,7794,4187,0,11981,7484,3241,257,10982,28570,-0.30106001168516816,-0.39561771561771564,Rep (McCain),Rep (Romney),6
indiana,putnam,8085,6331,0,14416,9004,4504,305,13813,38048,-0.12167036625971143,-0.3331359194551377,Rep (McCain),Rep (Romney),7
indiana,ohio,1712,1158,0,2870,1757,992,63,2812,6067,-0.19303135888501743,-0.2782830120043652,Rep (McCain),Rep (Romney),2
indiana,johnson,36471,21536,0,58007,39136,17080,1146,57362,135994,-0.2574689261640836,-0.3923438167069873,Rep (McCain),Rep (Romney),9
indiana,fayette,4917,4387,0,9304,5044,3553,219,8816,24367,-0.056964746345657784,-0.173432592764918,Rep (McCain),Rep (Romney),5
indiana,dubois,9526,8748,0,18274,11654,6522,366,18542,41809,-0.04257414906424428,-0.28235035211267606,Rep (McCain),Rep (Romney),7
indiana,wayne,14558,13459,0,28017,14321,10591,546,25458,69187,-0.03922618410250919,-0.14972703917790622,Rep (McCain),Rep (Romney),8
indiana,sullivan,4341,4282,0,8623,4902,3191,196,8289,21520,-0.006842166299431752,-0.2114172741875695,Rep (McCain),Rep (Romney),5
indiana,martin,3112,1706,0,4818,3262,1351,129,4742,10324,-0.29182233291822335,-0.4142640364188164,Rep (McCain),Rep (Romney),3
indiana,madison,26403,30152,0,56555,26755,24404,1181,52340,131444,0.06628945274511537,-0.04595476846693641,Dem (Obama),Rep (Romney),9
indiana,knox,8639,7569,0,16208,9612,5228,305,15145,38425,-0.0660167818361303,-0.2954177897574124,Rep (McCain),Rep (Romney),7
indiana,jennings,6257,5302,0,11559,6112,3818,307,10237,28470,-0.08261960377195258,-0.2310171198388721,Rep (McCain),Rep (Romney),6
indiana,huntington,10289,5842,0,16131,10862,4596,295,15753,37321,-0.2756803669952266,-0.40535644973476515,Rep (McCain),Rep (Romney),7
indiana,montgomery,9055,6005,0,15060,9768,4244,337,14349,38138,-0.20252324037184594,-0.3942335141307451,Rep (McCain),Rep (Romney),7
indiana,franklin,7017,3404,0,10421,7421,2907,221,10549,23194,-0.34670377123116786,-0.4370642912470953,Rep (McCain),Rep (Romney),5
indiana,tipton,4452,3250,0,7702,4773,2432,159,7364,16132,-0.1560633601661906,-0.32491325468424703,Rep (McCain),Rep (Romney),4
indiana,perry,3201,5140,0,8341,3403,4314,149,7866,19316,0.2324661311593334,0.11805105610988727,Dem (Obama),Dem (Obama),5
indiana,harrison,10529,7271,0,17800,10629,6600,417,17646,38616,-0.18303370786516854,-0.23384990423123803,Rep (McCain),Rep (Romney),7
indiana,brown,4060,3852,0,7912,4330,3056,204,7590,15271,-0.0262891809908999,-0.17248849174113187,Rep (McCain),Rep (Romney),4
indiana,union,2058,1220,0,3278,2022,1018,59,3099,7463,-0.2556436851738865,-0.33026315789473687,Rep (McCain),Rep (Romney),2
indiana,allen,77102,70844,0,147946,84378,59834,2193,146405,351332,-0.042299217281981265,-0.1701938812304108,Rep (McCain),Rep (Romney),10
indiana,white,5730,4839,0,10569,5970,3635,296,9901,24734,-0.08430315072381493,-0.2431025507548152,Rep (McCain),Rep (Romney),5
indiana,newton,3300,2623,0,5923,3291,2212,149,5652,14300,-0.11430018571669762,-0.1960748682536798,Rep (McCain),Rep (Romney),4
indiana,lawrence,11018,7208,0,18226,11622,5779,421,17822,46192,-0.2090420278722704,-0.3357852996954198,Rep (McCain),Rep (Romney),7
indiana,laporte,17911,28247,0,46158,18609,24104,944,43657,110937,0.22392651328047142,0.1286493573385152,Dem (Obama),Dem (Obama),9
indiana,lake,67417,138603,0,206020,68397,130824,2427,201648,494417,0.3455295602368702,0.313355519749424,Dem (Obama),Dem (Obama),10
indiana,hendricks,39578,24394,0,63972,44308,21100,1182,66590,140028,-0.23735384230600887,-0.35481898238747556,Rep (McCain),Rep (Romney),9
indiana,clark,25299,21918,0,47217,25422,20775,865,47062,107381,-0.0716055657919817,-0.10059094746412105,Rep (McCain),Rep (Romney),9
iowa,webster,8299,9847,0,18146,8453,9458,207,18118,38286,0.08530805687203792,0.05611076991792753,Dem (Obama),Dem (Obama),7
iowa,emmet,2366,2565,0,4931,2499,2087,60,4646,10389,0.040356925572906106,-0.08983863933711295,Dem (Obama),Rep (Romney),3
iowa,clayton,3640,5174,0,8814,4146,4768,121,9035,18202,0.17404129793510326,0.06977787749607359,Dem (Obama),Dem (Obama),4
iowa,scott,36239,48675,0,84914,38223,50581,1022,89826,162184,0.1464540594012766,0.13916039818026216,Dem (Obama),Dem (Obama),9
iowa,decatur,2019,1983,0,4002,1945,1790,77,3812,8508,-0.008995502248875561,-0.041499330655957165,Rep (McCain),Rep (Romney),2
iowa,shelby,3472,2847,0,6319,3903,2468,85,6456,12328,-0.09890805507200506,-0.22523936587662846,Rep (McCain),Rep (Romney),3
iowa,delaware,4108,4630,0,8738,4628,4605,90,9323,17857,0.059739070725566494,-0.0024910646593739845,Dem (Obama),Rep (Romney),4
iowa,ringgold,1401,1236,0,2637,1366,1181,31,2578,5169,-0.06257110352673492,-0.07263447192775814,Rep (McCain),Rep (Romney),1
iowa,polk,88983,119569,0,208552,96029,128264,3270,227563,419301,0.14665886685335072,0.14371826138131819,Dem (Obama),Dem (Obama),10
iowa,crawford,3338,3697,0,7035,3584,3035,67,6686,16951,0.051030561478322675,-0.08294304275570327,Dem (Obama),Rep (Romney),4
iowa,buchanan,4131,6037,0,10168,4443,5903,132,10478,21026,0.18745082612116443,0.14111734003479606,Dem (Obama),Dem (Obama),5
iowa,hancock,3008,2790,0,5798,3306,2506,69,5881,11505,-0.03759917212832011,-0.13764624913971094,Rep (McCain),Rep (Romney),3
iowa,cedar,4278,5201,0,9479,4510,4931,107,9548,18414,0.09737314062664838,0.04459273382056986,Dem (Obama),Dem (Obama),4
iowa,boone,6265,7333,0,13598,6540,7457,240,14237,26424,0.07854096190616267,0.0655140387225834,Dem (Obama),Dem (Obama),6
iowa,osceola,2027,1037,0,3064,2225,909,45,3179,6576,-0.32310704960835507,-0.419910657306956,Rep (McCain),Rep (Romney),2
iowa,obrien,4883,2333,0,7216,5259,1964,72,7295,14419,-0.35338137472283815,-0.4561816419770179,Rep (McCain),Rep (Romney),4
iowa,lyon,4461,1673,0,6134,4965,1416,85,6466,11564,-0.45451581349853276,-0.5561824165491303,Rep (McCain),Rep (Romney),3
iowa,lee,6724,9470,0,16194,6787,9428,273,16488,35991,0.16956897616401137,0.16287388220783225,Dem (Obama),Dem (Obama),6
iowa,jones,4398,5431,0,9829,4712,5514,145,10371,20708,0.1050971614609828,0.07842753764912967,Dem (Obama),Dem (Obama),5
iowa,humboldt,2881,2151,0,5032,3099,1967,58,5124,9905,-0.14507154213036566,-0.2234504540071062,Rep (McCain),Rep (Romney),3
iowa,dubuque,16694,23791,0,40485,21265,28600,651,50516,92547,0.1752994936396196,0.14709716233831344,Dem (Obama),Dem (Obama),9
iowa,worth,1612,2560,0,4172,1743,2343,57,4143,7628,0.22722914669223393,0.14684287812041116,Dem (Obama),Dem (Obama),2
iowa,marion,9232,7408,0,16640,9810,7478,248,17536,33378,-0.10961538461538461,-0.13489125404905136,Rep (McCain),Rep (Romney),6
iowa,greene,2340,2359,0,4699,2373,2369,62,4804,9448,0.0040434134922323894,-8.435259384226065e-4,Dem (Obama),Rep (Romney),3
iowa,chickasaw,2536,3897,0,6433,2836,3552,74,6462,12499,0.2115653660811441,0.11208515967438948,Dem (Obama),Dem (Obama),3
iowa,butler,3686,3348,0,7034,4104,3321,85,7510,14892,-0.048052317315894225,-0.10545454545454545,Rep (McCain),Rep (Romney),4
iowa,sioux,13440,3010,0,16450,14361,2683,137,17181,33377,-0.6340425531914894,-0.6851678009856841,Rep (McCain),Rep (Romney),6
iowa,paloalto,2290,2420,0,4710,2649,2124,84,4857,9508,0.027600849256900213,-0.10999371464487744,Dem (Obama),Rep (Romney),3
iowa,howard,1721,2933,0,4654,1793,2767,65,4625,9610,0.26042114310270736,0.21359649122807017,Dem (Obama),Dem (Obama),3
iowa,vanburen,1980,1540,0,3520,2058,1398,84,3540,7645,-0.125,-0.1909722222222222,Rep (McCain),Rep (Romney),2
iowa,tama,3813,4859,0,8672,4076,4737,117,8930,17952,0.12061808118081181,0.07500283671848405,Dem (Obama),Dem (Obama),4
iowa,allamakee,2961,3962,0,6923,3230,3511,83,6824,14331,0.14459049544994945,0.041685209909508976,Dem (Obama),Dem (Obama),4
iowa,calhoun,2747,2335,0,5082,2890,2232,68,5190,9846,-0.08107044470680834,-0.12846544318625536,Rep (McCain),Rep (Romney),3
iowa,appanoose,3081,2964,0,6045,3153,2934,89,6176,13029,-0.01935483870967742,-0.035978314440611135,Rep (McCain),Rep (Romney),3
iowa,winnebago,2726,3236,0,5962,2897,2895,86,5878,10962,0.08554176450855418,-3.453038674033149e-4,Dem (Obama),Rep (Romney),3
iowa,iowa,4173,4173,0,8346,4551,4118,119,8788,16353,0,-0.04994809089860422,Rep (McCain),Rep (Romney),4
iowa,dallas,16904,15101,0,32005,20921,16466,412,37799,61714,-0.05633494766442743,-0.11915906598550298,Rep (McCain),Rep (Romney),8
iowa,monona,2407,2284,0,4691,2555,2098,54,4707,9346,-0.026220422084843317,-0.09821620459918333,Rep (McCain),Rep (Romney),3
iowa,marshall,8229,9918,0,18147,8411,10085,231,18727,40131,0.09307323524549513,0.0905060553633218,Dem (Obama),Dem (Obama),7
iowa,guthrie,3025,2603,0,5628,3164,2565,114,5843,11040,-0.0749822316986496,-0.10455576889509513,Rep (McCain),Rep (Romney),3
iowa,dickinson,5150,4609,0,9759,5911,4088,119,10118,16665,-0.055436007787683164,-0.18231823182318233,Rep (McCain),Rep (Romney),4
iowa,winneshiek,4260,6808,0,11068,4618,6245,153,11016,21031,0.23021322732200938,0.14977446377612078,Dem (Obama),Dem (Obama),5
iowa,clay,4345,3908,0,8253,4934,3363,103,8400,16718,-0.05295044226341936,-0.18934554658310232,Rep (McCain),Rep (Romney),4
iowa,carroll,4905,5284,0,10189,5577,4912,92,10581,20805,0.037196977132201395,-0.0633997521212699,Dem (Obama),Rep (Romney),5
iowa,buenavista,4217,4065,0,8282,4548,3683,91,8322,19980,-0.01835305481767689,-0.10509051148098651,Rep (McCain),Rep (Romney),5
iowa,adams,1039,1113,0,2152,1103,1018,37,2158,4127,0.03438661710037175,-0.040075436115040074,Dem (Obama),Rep (Romney),1
iowa,taylor,1602,1344,0,2946,1680,1261,37,2978,6402,-0.08757637474541752,-0.14246854811288678,Rep (McCain),Rep (Romney),2
iowa,grundy,3936,2774,0,6710,4205,2615,70,6890,12401,-0.17317436661698957,-0.23313782991202345,Rep (McCain),Rep (Romney),3
iowa,desmoines,7687,12396,0,20083,8130,11873,261,20264,40266,0.2344769207787681,0.18712193171024347,Dem (Obama),Dem (Obama),7
iowa,pocahontas,2131,1794,0,3925,2388,1518,86,3992,7509,-0.08585987261146497,-0.2227342549923195,Rep (McCain),Rep (Romney),2
iowa,henry,5582,5306,0,10888,5025,4451,137,9613,20263,-0.025349008082292433,-0.06057408189109329,Rep (McCain),Rep (Romney),5
iowa,cherokee,3365,2883,0,6248,3656,2623,88,6367,12086,-0.07714468629961588,-0.16451664277751235,Rep (McCain),Rep (Romney),3
iowa,blackhawk,24467,38564,0,63031,26078,39338,789,66205,129252,0.22365185384969302,0.20270270270270271,Dem (Obama),Dem (Obama),9
iowa,jackson,3662,6069,0,9731,4171,5877,118,10166,19942,0.24735381769602302,0.16978503184713375,Dem (Obama),Dem (Obama),5
iowa,fremont,2708,2490,0,5198,1971,1636,48,3655,7528,-0.04193920738745671,-0.09287496534516218,Rep (McCain),Rep (Romney),2
iowa,washington,5228,5140,0,10368,5540,5081,259,10880,21626,-0.008487654320987654,-0.04321626965445815,Rep (McCain),Rep (Romney),5
iowa,pottawattamie,21161,20226,0,41387,21751,19347,581,41679,91928,-0.022591635054485706,-0.05849433062436128,Rep (McCain),Rep (Romney),9
iowa,mitchell,2465,3175,0,5640,2643,2831,106,5580,10801,0.12588652482269502,0.034344172451589335,Dem (Obama),Dem (Obama),3
iowa,cerrogordo,9344,14305,0,23649,10084,13204,260,23548,44324,0.2097763118947947,0.13397457918241154,Dem (Obama),Dem (Obama),7
iowa,clinton,9068,14733,0,23801,9423,15123,327,24873,49274,0.2380152094449813,0.23221706184307014,Dem (Obama),Dem (Obama),7
iowa,plymouth,7744,4564,0,12308,8577,4148,184,12909,24933,-0.25836854078648036,-0.3480550098231827,Rep (McCain),Rep (Romney),5
iowa,monroe,1997,1793,0,3790,2022,1729,51,3802,7918,-0.05382585751978892,-0.07811250333244468,Rep (McCain),Rep (Romney),2
iowa,hardin,4301,4368,0,8669,4647,4021,107,8775,17685,0.007728688430038067,-0.07221965851407476,Dem (Obama),Rep (Romney),4
iowa,mills,4177,2970,0,7147,4211,2842,116,7169,15157,-0.1688820484119211,-0.19410180065220473,Rep (McCain),Rep (Romney),4
iowa,davis,2553,2262,0,4815,2133,1518,87,3738,8687,-0.06043613707165109,-0.1684470008216927,Rep (McCain),Rep (Romney),2
iowa,jefferson,3321,5028,0,8349,3429,4772,204,8405,16643,0.20445562342795545,0.1637605170101207,Dem (Obama),Dem (Obama),4
iowa,benton,6431,7035,0,13466,6935,6850,174,13959,26098,0.04485370562899153,-0.006166122597025753,Dem (Obama),Rep (Romney),6
iowa,wright,3187,3087,0,6274,3309,2794,71,6174,13384,-0.015938795027095953,-0.08438472882189087,Rep (McCain),Rep (Romney),3
iowa,bremer,5704,6870,0,12574,6383,6710,125,13218,24185,0.09273103228885,0.024975177575803864,Dem (Obama),Dem (Obama),5
iowa,mahaska,6249,4450,0,10699,6420,4207,150,10777,22382,-0.1681465557528741,-0.20824315422979203,Rep (McCain),Rep (Romney),5
iowa,hamilton,3909,3999,0,7908,3986,3776,110,7872,15874,0.011380880121396054,-0.027054882762174697,Dem (Obama),Rep (Romney),4
iowa,cass,3990,3201,0,7191,4212,2856,99,7167,13969,-0.10972048393825615,-0.19185059422750425,Rep (McCain),Rep (Romney),4
iowa,poweshiek,4331,5441,0,9772,4409,5307,142,9858,19012,0.1135898485468686,0.09242486620008233,Dem (Obama),Dem (Obama),4
iowa,jasper,8750,10195,0,18945,8868,10240,277,19385,37050,0.07627342306677223,0.07180238643500104,Dem (Obama),Dem (Obama),7
iowa,warren,12112,12261,0,24373,13031,12521,323,25875,45346,0.0061133221187379475,-0.01995929868503444,Dem (Obama),Rep (Romney),7
iowa,floyd,3044,4797,0,7841,3466,4674,88,8228,16394,0.22356842239510266,0.1484029484029484,Dem (Obama),Dem (Obama),4
iowa,sac,2699,2237,0,4936,3086,2117,53,5256,10480,-0.09359805510534847,-0.18623870843743995,Rep (McCain),Rep (Romney),3
iowa,keokuk,2703,2508,0,5211,2840,2298,83,5221,10614,-0.03742084052964882,-0.10548851693265862,Rep (McCain),Rep (Romney),3
iowa,woodbury,20798,20290,0,41088,22136,22026,540,44702,101217,-0.012363707165109034,-0.002490829219691137,Rep (McCain),Rep (Romney),9
iowa,page,4344,2892,0,7236,4338,2588,88,7014,16095,-0.20066334991708126,-0.2526710944267976,Rep (McCain),Rep (Romney),4
iowa,linn,43384,67476,0,110860,47427,68028,1667,117122,207765,0.2173191412592459,0.17843315577497726,Dem (Obama),Dem (Obama),10
iowa,johnson,20639,50708,0,71347,23556,50090,1282,74928,126994,0.42144729280838716,0.3602911223963284,Dem (Obama),Dem (Obama),9
iowa,lucas,2329,2024,0,4353,2248,1977,48,4273,9116,-0.07006662072134161,-0.06414201183431953,Rep (McCain),Rep (Romney),2
iowa,fayette,4199,5889,0,10088,4484,5709,116,10309,20992,0.16752577319587628,0.12018051604041989,Dem (Obama),Dem (Obama),5
iowa,clarke,2112,2214,0,4326,2124,2187,87,4398,9218,0.023578363384188627,0.014613778705636743,Dem (Obama),Dem (Obama),2
iowa,story,18812,26268,0,45080,19557,25940,1032,46529,87594,0.16539485359361136,0.14029496450315404,Dem (Obama),Dem (Obama),8
iowa,kossuth,4310,4609,0,8919,4914,3824,95,8833,15748,0.03352393766117278,-0.12474250400549325,Dem (Obama),Rep (Romney),4
iowa,wayne,1563,1356,0,2919,1583,1251,52,2886,6404,-0.07091469681397738,-0.11714890613973183,Rep (McCain),Rep (Romney),2
iowa,madison,4525,3702,0,8227,4492,3508,140,8140,15488,-0.10003646529719218,-0.123,Rep (McCain),Rep (Romney),4
iowa,audubon,1631,1731,0,3362,1800,1608,31,3439,6186,0.0297441998810232,-0.056338028169014086,Dem (Obama),Rep (Romney),2
iowa,muscatine,7907,10850,0,18757,8152,11213,361,19726,42501,0.15690142346857172,0.15806868060934676,Dem (Obama),Dem (Obama),7
iowa,montgomery,2878,2318,0,5196,2999,1919,82,5000,10901,-0.1077752117013087,-0.21960146400976008,Rep (McCain),Rep (Romney),3
iowa,louisa,2310,2520,0,4830,2416,2449,56,4921,11683,0.043478260869565216,0.0067831449126413155,Dem (Obama),Dem (Obama),3
iowa,franklin,2495,2566,0,5061,2818,2256,59,5133,10697,0.01402884805374432,-0.11076074103271581,Dem (Obama),Rep (Romney),3
iowa,harrison,3906,3549,0,7455,4059,3131,92,7282,15073,-0.04788732394366197,-0.12906815020862308,Rep (McCain),Rep (Romney),4
iowa,union,2774,2990,0,5764,2800,3029,70,5899,12409,0.03747397640527411,0.03928632698576085,Dem (Obama),Dem (Obama),3
iowa,adair,2059,1920,0,3979,2110,1788,61,3959,7779,-0.0349334003518472,-0.08260646485377117,Rep (McCain),Rep (Romney),2
iowa,wapello,6466,8481,0,14947,6777,8616,237,15630,35553,0.13480966080149862,0.11946988891054375,Dem (Obama),Dem (Obama),6
iowa,ida,2025,1455,0,3480,2276,1317,33,3626,7172,-0.16379310344827586,-0.26690787642638464,Rep (McCain),Rep (Romney),2
kansas,osage,4768,2508,0,7276,4336,2228,207,6771,16426,-0.31061022539857064,-0.3211456429006703,Rep (McCain),Rep (Romney),4
kansas,decatur,1189,340,0,1529,1219,266,48,1533,3015,-0.5552648790058862,-0.6417508417508417,Rep (McCain),Rep (Romney),1
kansas,graham,1043,323,0,1366,1044,248,27,1319,2663,-0.527086383601757,-0.6160990712074303,Rep (McCain),Rep (Romney),1
kansas,seward,3620,1376,0,4996,3495,1393,67,4955,22588,-0.44915932746196957,-0.4300327332242226,Rep (McCain),Rep (Romney),5
kansas,butler,17756,8942,0,26698,17764,7124,564,25452,64853,-0.3301370889205184,-0.42751526840244297,Rep (McCain),Rep (Romney),8
kansas,phillips,2066,516,0,2582,2116,376,45,2537,5601,-0.6003098373353989,-0.6982343499197432,Rep (McCain),Rep (Romney),2
kansas,rice,2746,1137,0,3883,2631,899,92,3622,10128,-0.4143703322173577,-0.4906515580736544,Rep (McCain),Rep (Romney),3
kansas,russell,2470,719,0,3189,2505,584,51,3140,6915,-0.5490749451238632,-0.6218841048883134,Rep (McCain),Rep (Romney),2
kansas,dickinson,5961,2353,0,8314,5709,1962,183,7854,19643,-0.4339668029829204,-0.48846304262807977,Rep (McCain),Rep (Romney),5
kansas,jackson,3770,2266,0,6036,3476,1870,128,5474,13360,-0.2491716368455931,-0.3004115226337449,Rep (McCain),Rep (Romney),3
kansas,elk,1035,359,0,1394,1040,277,39,1356,2930,-0.48493543758967,-0.5793470007593015,Rep (McCain),Rep (Romney),1
kansas,sumner,6637,3304,0,9941,6162,2617,210,8989,24257,-0.3352781410320893,-0.40380453354596196,Rep (McCain),Rep (Romney),5
kansas,sedgwick,104119,79175,0,183294,104411,69373,4068,177852,486123,-0.13608737874671292,-0.20161810063066796,Rep (McCain),Rep (Romney),10
kansas,shawnee,40806,40072,0,80878,37226,35959,1659,74844,175537,-0.00907539751230248,-0.017312290769966522,Rep (McCain),Rep (Romney),9
kansas,barber,1794,585,0,2379,1753,473,56,2282,4900,-0.5081967213114754,-0.5750224618149147,Rep (McCain),Rep (Romney),1
kansas,cloud,3070,1213,0,4283,2886,951,120,3957,9538,-0.4335745972449218,-0.5043002345582487,Rep (McCain),Rep (Romney),3
kansas,labette,4955,3782,0,8737,4668,3074,165,7907,21791,-0.13425660982030446,-0.20588995091707568,Rep (McCain),Rep (Romney),5
kansas,wyandotte,16211,38482,0,54693,15273,33265,884,49422,155462,0.4072001901523047,0.3706786435370225,Dem (Obama),Dem (Obama),9
kansas,rawlins,1243,270,0,1513,1207,184,29,1420,2594,-0.643093192333113,-0.7354421279654925,Rep (McCain),Rep (Romney),1
kansas,riley,11729,10033,0,21762,11157,8587,522,20266,69035,-0.07793401341788439,-0.13016612641815234,Rep (McCain),Rep (Romney),8
kansas,republic,1949,627,0,2576,2098,470,72,2640,5069,-0.5131987577639752,-0.6339563862928349,Rep (McCain),Rep (Romney),1
kansas,brown,2926,1284,0,4210,2738,1039,88,3865,10019,-0.3900237529691211,-0.4498279057453005,Rep (McCain),Rep (Romney),3
kansas,haskell,1216,265,0,1481,1131,202,22,1355,4196,-0.6421336934503714,-0.6969242310577645,Rep (McCain),Rep (Romney),1
kansas,douglas,17475,33141,0,50616,17028,28012,1243,46283,109052,0.30950687529634896,0.24387211367673178,Dem (Obama),Dem (Obama),9
kansas,leavenworth,16387,12749,0,29136,16825,11072,635,28532,74611,-0.12486271279516749,-0.2062228913503244,Rep (McCain),Rep (Romney),8
kansas,norton,1836,488,0,2324,1855,393,48,2296,5692,-0.5800344234079173,-0.650355871886121,Rep (McCain),Rep (Romney),2
kansas,anderson,2329,1161,0,3490,2246,937,91,3274,8084,-0.3346704871060172,-0.4112472510210493,Rep (McCain),Rep (Romney),2
kansas,harvey,8865,6185,0,15050,8352,5162,291,13805,34150,-0.17807308970099667,-0.23605150214592274,Rep (McCain),Rep (Romney),6
kansas,stanton,625,187,0,812,571,135,7,713,2197,-0.5394088669950738,-0.6175637393767706,Rep (McCain),Rep (Romney),1
kansas,grant,1941,616,0,2557,1742,437,36,2215,7744,-0.5181853734845522,-0.59889857732905,Rep (McCain),Rep (Romney),2
kansas,ellsworth,1996,838,0,2834,1905,696,76,2677,6476,-0.40860973888496827,-0.46482122260668973,Rep (McCain),Rep (Romney),2
kansas,clay,2919,982,0,3901,2715,811,58,3584,8531,-0.4965393488849013,-0.5399886557005105,Rep (McCain),Rep (Romney),2
kansas,cherokee,5750,3366,0,9116,5345,2868,183,8396,21740,-0.2615182097411145,-0.3015950322659199,Rep (McCain),Rep (Romney),5
kansas,greenwood,2087,916,0,3003,1986,653,67,2706,6824,-0.38994338994338995,-0.5051155740810913,Rep (McCain),Rep (Romney),2
kansas,sherman,1932,677,0,2609,1967,575,64,2606,6002,-0.4810272134917593,-0.5476003147128246,Rep (McCain),Rep (Romney),2
kansas,osborne,1441,391,0,1832,1448,320,34,1802,3906,-0.5731441048034934,-0.6380090497737556,Rep (McCain),Rep (Romney),1
kansas,wichita,835,163,0,998,821,157,9,987,2244,-0.6733466933867736,-0.6789366053169734,Rep (McCain),Rep (Romney),1
kansas,gove,1120,257,0,1377,1155,174,39,1368,2721,-0.6267247639796659,-0.7381489841986456,Rep (McCain),Rep (Romney),1
kansas,geary,4376,3368,0,7744,4242,3158,126,7526,30537,-0.13016528925619836,-0.1464864864864865,Rep (McCain),Rep (Romney),6
kansas,edwards,979,326,0,1305,1048,291,26,1365,3052,-0.5003831417624521,-0.5653472740851382,Rep (McCain),Rep (Romney),1
kansas,ford,5587,2848,0,8435,5459,2468,155,8082,32727,-0.3247184350918791,-0.3773180269963416,Rep (McCain),Rep (Romney),6
kansas,neosho,4372,2496,0,6868,4193,2012,154,6359,16538,-0.27315084449621435,-0.3514907332796132,Rep (McCain),Rep (Romney),4
kansas,pottawatomie,6816,2552,0,9368,6692,2291,320,9303,20781,-0.4551665243381725,-0.4899254146721585,Rep (McCain),Rep (Romney),5
kansas,allen,3481,2130,0,5611,3261,1842,118,5221,13473,-0.24077704509000178,-0.27807172251616696,Rep (McCain),Rep (Romney),3
kansas,clark,870,241,0,1111,791,171,38,1000,2231,-0.5661566156615662,-0.6444906444906445,Rep (McCain),Rep (Romney),1
kansas,harper,1960,740,0,2700,1723,536,76,2335,6033,-0.45185185185185184,-0.5254537405931828,Rep (McCain),Rep (Romney),2
kansas,ellis,8037,3917,0,11954,9057,3464,258,12779,28039,-0.34465450895097877,-0.4466895615366185,Rep (McCain),Rep (Romney),6
kansas,gray,1585,416,0,2001,1568,304,29,1901,5870,-0.584207896051974,-0.6752136752136753,Rep (McCain),Rep (Romney),2
kansas,mcpherson,8732,4113,0,12845,8399,3384,277,12060,29178,-0.3595951732191514,-0.42561317151828904,Rep (McCain),Rep (Romney),6
kansas,scott,1788,311,0,2099,1702,271,46,2019,4832,-0.7036684135302526,-0.7252914343639129,Rep (McCain),Rep (Romney),1
kansas,crawford,7453,7646,0,15099,7480,6545,360,14385,38985,0.01278230346380555,-0.06666666666666667,Dem (Obama),Rep (Romney),7
kansas,wabaunsee,2375,1020,0,3395,2230,908,91,3229,7004,-0.39911634756995584,-0.4212874442319949,Rep (McCain),Rep (Romney),2
kansas,trego,1215,415,0,1630,1230,289,25,1544,2979,-0.49079754601226994,-0.619486504279131,Rep (McCain),Rep (Romney),1
kansas,sheridan,1068,252,0,1320,1136,165,19,1320,2578,-0.6181818181818182,-0.7463489623366641,Rep (McCain),Rep (Romney),1
kansas,woodson,1045,507,0,1552,1030,377,28,1435,3352,-0.34664948453608246,-0.4641080312722104,Rep (McCain),Rep (Romney),1
kansas,jewell,1229,312,0,1541,1220,225,32,1477,3151,-0.5950681375730046,-0.6885813148788927,Rep (McCain),Rep (Romney),1
kansas,kiowa,903,197,0,1100,970,160,3,1133,2671,-0.6418181818181818,-0.7168141592920354,Rep (McCain),Rep (Romney),1
kansas,chautauqua,1396,385,0,1781,1201,259,42,1502,3736,-0.5676586187535093,-0.6452054794520548,Rep (McCain),Rep (Romney),1
kansas,meade,1527,369,0,1896,1394,254,0,1648,4523,-0.6107594936708861,-0.691747572815534,Rep (McCain),Rep (Romney),1
kansas,rooks,2054,467,0,2521,2159,398,68,2625,5241,-0.6295120983736613,-0.6886976926085256,Rep (McCain),Rep (Romney),1
kansas,logan,1171,222,0,1393,1084,194,24,1302,2774,-0.6812634601579325,-0.6964006259780907,Rep (McCain),Rep (Romney),1
kansas,doniphan,2336,1077,0,3413,2397,885,87,3369,7957,-0.3688836800468796,-0.4606946983546618,Rep (McCain),Rep (Romney),2
kansas,jefferson,5058,3450,0,8508,4647,2883,195,7725,19059,-0.18899858956276447,-0.2342629482071713,Rep (McCain),Rep (Romney),5
kansas,wallace,690,96,0,786,702,68,11,781,1440,-0.7557251908396947,-0.8233766233766234,Rep (McCain),Rep (Romney),1
kansas,hamilton,836,233,0,1069,678,159,20,857,2643,-0.5640785781103835,-0.6200716845878136,Rep (McCain),Rep (Romney),1
kansas,lane,786,187,0,973,732,170,15,917,1725,-0.6156217882836588,-0.623059866962306,Rep (McCain),Rep (Romney),1
kansas,reno,15858,9711,0,25569,15398,7888,583,23869,64054,-0.2404083069341781,-0.32251138022846343,Rep (McCain),Rep (Romney),8
kansas,kearny,1138,302,0,1440,1060,261,20,1341,3966,-0.5805555555555556,-0.6048448145344436,Rep (McCain),Rep (Romney),1
kansas,linn,3029,1401,0,4430,3079,1108,107,4294,9782,-0.3674943566591422,-0.47074277525674707,Rep (McCain),Rep (Romney),3
kansas,cheyenne,1247,432,0,1679,1157,231,34,1422,2783,-0.4854079809410363,-0.6671469740634006,Rep (McCain),Rep (Romney),1
kansas,franklin,6969,4366,0,11335,6893,3611,302,10806,25841,-0.22964269960299957,-0.3124523990860624,Rep (McCain),Rep (Romney),5
kansas,montgomery,9142,4203,0,13345,8417,3406,270,12093,35453,-0.37010116148370176,-0.4238348980800135,Rep (McCain),Rep (Romney),6
kansas,comanche,756,194,0,950,756,141,18,915,1865,-0.5915789473684211,-0.68561872909699,Rep (McCain),Rep (Romney),1
kansas,lyon,6468,5661,0,12129,6358,4972,284,11614,34974,-0.06653475142221123,-0.12233009708737864,Rep (McCain),Rep (Romney),6
kansas,marion,3695,1607,0,5302,3865,1371,132,5368,12689,-0.3938136552244436,-0.4763177998472116,Rep (McCain),Rep (Romney),3
kansas,atchison,3717,3157,0,6874,3836,2486,177,6499,16889,-0.0814663951120163,-0.213540018981335,Rep (McCain),Rep (Romney),4
kansas,barton,7636,2967,0,10603,9132,2693,185,12010,27499,-0.4403470715835141,-0.5445243128964059,Rep (McCain),Rep (Romney),6
kansas,coffey,3008,1105,0,4113,2860,884,95,3839,8587,-0.462679309506443,-0.5277777777777778,Rep (McCain),Rep (Romney),2
kansas,cowley,8263,4859,0,13122,7932,4219,293,12444,36140,-0.2594116750495351,-0.30557155789646945,Rep (McCain),Rep (Romney),6
kansas,stevens,1770,277,0,2047,1724,241,33,1998,5533,-0.7293600390815828,-0.7547073791348601,Rep (McCain),Rep (Romney),2
kansas,wilson,2927,1218,0,4145,2812,813,74,3699,9598,-0.41230398069963814,-0.551448275862069,Rep (McCain),Rep (Romney),3
kansas,hodgeman,836,202,0,1038,857,178,15,1050,1955,-0.6107899807321773,-0.6560386473429952,Rep (McCain),Rep (Romney),1
kansas,marshall,3150,1779,0,4929,3123,1451,105,4679,10147,-0.278149726110773,-0.3655443812855269,Rep (McCain),Rep (Romney),3
kansas,morton,1129,225,0,1354,1050,180,17,1247,3244,-0.6676514032496307,-0.7073170731707317,Rep (McCain),Rep (Romney),1
kansas,greeley,587,150,0,737,539,112,14,665,1294,-0.592944369063772,-0.6559139784946236,Rep (McCain),Rep (Romney),1
kansas,stafford,1483,535,0,2018,1382,403,48,1833,4433,-0.4697720515361744,-0.5484593837535015,Rep (McCain),Rep (Romney),1
kansas,washington,2193,640,0,2833,2300,515,48,2863,5851,-0.5481821390751853,-0.6341030195381883,Rep (McCain),Rep (Romney),2
kansas,mitchell,2405,692,0,3097,2293,576,54,2923,6383,-0.5531159186309331,-0.5984663645869641,Rep (McCain),Rep (Romney),2
kansas,pawnee,1923,869,0,2792,1808,704,53,2565,6913,-0.37750716332378226,-0.4394904458598726,Rep (McCain),Rep (Romney),2
kansas,rush,1217,498,0,1715,1151,361,37,1549,3290,-0.4192419825072886,-0.5224867724867724,Rep (McCain),Rep (Romney),1
kansas,ness,1197,283,0,1480,1190,211,16,1417,3120,-0.6175675675675676,-0.6987865810135617,Rep (McCain),Rep (Romney),1
kansas,miami,9229,5644,0,14873,9726,4635,281,14642,32116,-0.24104081221004506,-0.35450177564236474,Rep (McCain),Rep (Romney),6
kansas,morris,1858,897,0,2755,1750,705,71,2526,5946,-0.3488203266787659,-0.4256619144602851,Rep (McCain),Rep (Romney),2
kansas,nemaha,3761,1405,0,5166,3878,988,93,4959,10253,-0.45605884630274873,-0.5939169749280724,Rep (McCain),Rep (Romney),3
kansas,saline,13754,7897,0,21651,13697,6910,495,21102,54982,-0.27051868273982727,-0.32935410297471734,Rep (McCain),Rep (Romney),8
kansas,ottawa,2304,703,0,3007,2260,548,80,2888,6107,-0.5324243431992018,-0.6096866096866097,Rep (McCain),Rep (Romney),2
kansas,thomas,2762,761,0,3523,2729,576,83,3388,7757,-0.5679818336644905,-0.6514372163388805,Rep (McCain),Rep (Romney),2
kansas,johnson,149816,124142,0,273958,155442,107651,5052,268145,531228,-0.09371509501456428,-0.18165059503673606,Rep (McCain),Rep (Romney),10
kansas,pratt,2765,1265,0,4030,2730,974,48,3752,9670,-0.37220843672456577,-0.4740820734341253,Rep (McCain),Rep (Romney),3
kansas,chase,934,371,0,1305,857,343,33,1233,2834,-0.4314176245210728,-0.42833333333333334,Rep (McCain),Rep (Romney),1
kansas,finney,6776,3188,0,9964,5108,2307,178,7593,36139,-0.36009634684865516,-0.3777478084962913,Rep (McCain),Rep (Romney),6
kansas,kingman,2468,918,0,3386,2371,731,97,3199,7949,-0.45776727702303605,-0.5286911669890393,Rep (McCain),Rep (Romney),2
kansas,smith,1695,437,0,2132,1598,345,40,1983,3934,-0.5900562851782364,-0.6448790530108081,Rep (McCain),Rep (Romney),1
kansas,bourbon,4159,2343,0,6502,4022,1951,145,6118,15097,-0.2792986773300523,-0.34672693788715886,Rep (McCain),Rep (Romney),4
kansas,lincoln,1175,334,0,1509,1148,284,27,1459,3308,-0.5573227302849569,-0.6033519553072626,Rep (McCain),Rep (Romney),1
kentucky,butler,3696,1555,0,5251,3716,1293,49,5058,12763,-0.40773186059798133,-0.4837292872828908,Rep (McCain),Rep (Romney),3
kentucky,menifee,1155,1276,0,2431,1484,1048,66,2598,6427,0.049773755656108594,-0.1721958925750395,Dem (Obama),Rep (Romney),2
kentucky,oldham,18992,9996,0,28988,20179,9240,454,29873,58784,-0.31033531116324,-0.37183452870593836,Rep (McCain),Rep (Romney),8
kentucky,lewis,3213,1510,0,4723,3326,1342,101,4769,13968,-0.36057590514503496,-0.4250214224507284,Rep (McCain),Rep (Romney),4
kentucky,russell,5702,1579,0,7281,6346,1445,116,7907,17445,-0.5662683697294327,-0.6290591708381466,Rep (McCain),Rep (Romney),4
kentucky,breathitt,2671,2205,0,4876,3318,1562,128,5008,14202,-0.0955701394585726,-0.3598360655737705,Rep (McCain),Rep (Romney),4
kentucky,knott,2950,2523,0,5473,4130,1420,143,5693,16587,-0.07801936780559109,-0.4882882882882883,Rep (McCain),Rep (Romney),4
kentucky,trigg,4189,2246,0,6435,4520,2115,105,6740,14117,-0.30194250194250194,-0.3624717407686511,Rep (McCain),Rep (Romney),4
kentucky,jackson,4407,743,0,5150,4365,612,84,5061,13560,-0.7114563106796117,-0.7540687160940326,Rep (McCain),Rep (Romney),3
kentucky,nelson,10139,7654,0,17793,10673,7611,248,18532,42523,-0.13966166469960098,-0.16746882520236273,Rep (McCain),Rep (Romney),7
kentucky,monroe,3537,1067,0,4604,3762,936,48,4746,11089,-0.5364900086880973,-0.6015325670498084,Rep (McCain),Rep (Romney),3
kentucky,bullitt,19857,10056,0,29913,21306,9971,498,31775,72515,-0.32765018553806036,-0.36240688045528663,Rep (McCain),Rep (Romney),8
kentucky,morgan,2377,1858,0,4235,3021,1369,82,4472,14055,-0.12255017709563164,-0.3763097949886105,Rep (McCain),Rep (Romney),4
kentucky,letcher,5367,2623,0,7990,6811,1702,245,8758,24462,-0.34342928660826033,-0.6001409608833549,Rep (McCain),Rep (Romney),5
kentucky,madison,19694,12392,0,32086,21128,11512,677,33317,81580,-0.2275758897961728,-0.2946078431372549,Rep (McCain),Rep (Romney),8
kentucky,knox,8150,3074,0,11224,8467,2484,149,11100,31765,-0.4522451888809694,-0.5463427997443155,Rep (McCain),Rep (Romney),6
kentucky,mclean,2386,1963,0,4349,2705,1432,63,4200,9635,-0.09726373879052656,-0.3077109016195311,Rep (McCain),Rep (Romney),3
kentucky,harrison,4520,2916,0,7436,4556,2471,136,7163,18761,-0.2157073695535234,-0.29671267966415255,Rep (McCain),Rep (Romney),4
kentucky,livingston,2890,1622,0,4512,3089,1346,76,4511,9514,-0.28102836879432624,-0.39301014656144306,Rep (McCain),Rep (Romney),3
kentucky,ballard,2537,1427,0,3964,2647,1189,59,3895,8225,-0.28002018163471243,-0.3800834202294056,Rep (McCain),Rep (Romney),2
kentucky,webster,3037,2390,0,5427,3607,1765,98,5470,13734,-0.11921872120877096,-0.3428890543559196,Rep (McCain),Rep (Romney),3
kentucky,calloway,8991,6165,0,15156,9438,5314,312,15064,36763,-0.18646080760095013,-0.27955531453362253,Rep (McCain),Rep (Romney),7
kentucky,shelby,11451,6871,0,18322,11790,6634,235,18659,40899,-0.24997271040279445,-0.2798523664785063,Rep (McCain),Rep (Romney),7
kentucky,greenup,8849,6621,0,15470,8855,6027,277,15159,36962,-0.14402068519715577,-0.19002822201317027,Rep (McCain),Rep (Romney),7
kentucky,lee,1978,752,0,2730,1977,595,51,2623,7865,-0.4490842490842491,-0.5373250388802489,Rep (McCain),Rep (Romney),2
kentucky,anderson,6884,3461,0,10345,6822,3315,181,10318,21080,-0.330884485258579,-0.3459603432968334,Rep (McCain),Rep (Romney),5
kentucky,pike,12665,9525,0,22190,17589,5645,398,23632,65309,-0.14150518251464625,-0.5140742016011018,Rep (McCain),Rep (Romney),8
kentucky,whitley,10014,3484,0,13498,10232,2683,153,13068,36006,-0.48377537412950067,-0.5845141308555942,Rep (McCain),Rep (Romney),6
kentucky,grant,5605,3109,0,8714,5664,2810,132,8606,24604,-0.28643562084002755,-0.3367949020533396,Rep (McCain),Rep (Romney),5
kentucky,wolfe,1408,1493,0,2901,1542,976,41,2559,7315,0.02930024129610479,-0.22478157267672755,Dem (Obama),Rep (Romney),2
kentucky,henderson,9523,10049,0,19572,10296,8091,227,18614,45943,0.02687512773349683,-0.11992168379833579,Dem (Obama),Rep (Romney),7
kentucky,owsley,1279,381,0,1660,1279,283,18,1580,4742,-0.5409638554216868,-0.6376440460947503,Rep (McCain),Rep (Romney),1
kentucky,gallatin,1840,1278,0,3118,1758,1238,64,3060,8428,-0.1802437459910199,-0.17356475300400534,Rep (McCain),Rep (Romney),2
kentucky,clay,5710,1552,0,7262,6176,1111,96,7383,22197,-0.5725695400716057,-0.695073418416358,Rep (McCain),Rep (Romney),5
kentucky,larue,4153,1913,0,6066,3911,1733,120,5764,14080,-0.3692713484998352,-0.385896527285613,Rep (McCain),Rep (Romney),4
kentucky,fulton,1530,1226,0,2756,1425,1022,34,2481,6858,-0.11030478955007257,-0.16469145892930118,Rep (McCain),Rep (Romney),2
kentucky,warren,25957,17650,0,43607,26384,16805,700,43889,109775,-0.1904969385649093,-0.22179258607515803,Rep (McCain),Rep (Romney),9
kentucky,rowan,3907,4074,0,7981,4035,3438,168,7641,23075,0.02092469615336424,-0.07988759534323565,Dem (Obama),Rep (Romney),5
kentucky,breckinridge,5281,3110,0,8391,5025,2825,117,7967,19893,-0.25872959122869743,-0.2802547770700637,Rep (McCain),Rep (Romney),5
kentucky,laurel,17563,4593,0,22156,18151,3905,352,22408,58155,-0.5853944755371006,-0.6459013420384476,Rep (McCain),Rep (Romney),8
kentucky,mccracken,19043,11285,0,30328,19979,10062,499,30540,65217,-0.25580321814824586,-0.3301155088046337,Rep (McCain),Rep (Romney),8
kentucky,campbell,24045,15619,0,39664,24240,15080,853,40173,89016,-0.21243444937474787,-0.23296032553407936,Rep (McCain),Rep (Romney),8
kentucky,martin,2824,808,0,3632,3180,574,70,3824,13138,-0.5550660792951542,-0.6941928609483218,Rep (McCain),Rep (Romney),3
kentucky,perry,6762,3444,0,10206,8040,2047,153,10240,28739,-0.32510288065843623,-0.5941310597799148,Rep (McCain),Rep (Romney),6
kentucky,allen,5258,2023,0,7281,5184,1808,107,7099,19688,-0.44430710067298446,-0.482837528604119,Rep (McCain),Rep (Romney),5
kentucky,clark,9664,5749,0,15413,9931,5228,251,15410,35305,-0.2540063582689937,-0.31024473909888517,Rep (McCain),Rep (Romney),6
kentucky,scott,11782,7712,0,19494,12679,7532,354,20565,44868,-0.20878218939160767,-0.2546633021621889,Rep (McCain),Rep (Romney),7
kentucky,carlisle,1699,879,0,2578,1835,750,34,2619,5126,-0.3180760279286268,-0.4197292069632495,Rep (McCain),Rep (Romney),1
kentucky,pendleton,3676,2027,0,5703,3556,1859,119,5534,14894,-0.28914606347536387,-0.3133887349953832,Rep (McCain),Rep (Romney),4
kentucky,nicholas,1634,1272,0,2906,1583,948,49,2580,7136,-0.12456985547143841,-0.2508889766890557,Rep (McCain),Rep (Romney),2
kentucky,spencer,5378,2519,0,7897,5726,2549,156,8431,16582,-0.36203621628466504,-0.3839274924471299,Rep (McCain),Rep (Romney),4
kentucky,graves,10056,5843,0,15899,10699,4547,247,15493,36958,-0.26498521919617585,-0.403515676242949,Rep (McCain),Rep (Romney),7
kentucky,hickman,1406,812,0,2218,1431,686,22,2139,4949,-0.2678088367899008,-0.3519130845536136,Rep (McCain),Rep (Romney),1
kentucky,jessamine,13710,6236,0,19946,14232,6001,387,20620,47073,-0.3747117216484508,-0.40681065585923987,Rep (McCain),Rep (Romney),7
kentucky,muhlenberg,6447,6221,0,12668,7762,4771,204,12737,31541,-0.017840227344490055,-0.23864996409478975,Rep (McCain),Rep (Romney),6
kentucky,crittenden,2604,1254,0,3858,2839,960,55,3854,9313,-0.3499222395023328,-0.49460384311660965,Rep (McCain),Rep (Romney),3
kentucky,kenton,33371,21460,0,54831,41387,24917,1375,67679,158034,-0.2172311283762835,-0.2484013030888031,Rep (McCain),Rep (Romney),9
kentucky,bracken,2066,1241,0,3307,2029,1147,54,3230,8479,-0.24947081947384336,-0.2777078085642317,Rep (McCain),Rep (Romney),2
kentucky,powell,2867,2065,0,4932,2726,1620,95,4441,12786,-0.16261151662611517,-0.25448688449148643,Rep (McCain),Rep (Romney),3
kentucky,robertson,533,451,0,984,579,340,16,935,2278,-0.08333333333333333,-0.2600652883569097,Rep (McCain),Rep (Romney),1
kentucky,estill,3685,1555,0,5240,3749,1356,79,5184,14733,-0.4064885496183206,-0.46875612144955925,Rep (McCain),Rep (Romney),4
kentucky,meade,6691,4343,0,11034,6606,4122,187,10915,28907,-0.2127968098604314,-0.23154362416107382,Rep (McCain),Rep (Romney),6
kentucky,trimble,2239,1484,0,3723,2133,1355,52,3540,8872,-0.2027934461455815,-0.22305045871559634,Rep (McCain),Rep (Romney),2
kentucky,simpson,4437,2775,0,7212,4355,2650,84,7089,17214,-0.23044925124792012,-0.24339757316202712,Rep (McCain),Rep (Romney),4
kentucky,logan,6925,3811,0,10736,6899,3469,141,10509,26838,-0.2900521609538003,-0.3308256172839506,Rep (McCain),Rep (Romney),6
kentucky,henry,4081,2724,0,6805,3940,2529,115,6584,15474,-0.1994121969140338,-0.21811717421548926,Rep (McCain),Rep (Romney),4
kentucky,mason,4102,2891,0,6993,4197,2592,90,6879,17362,-0.17317317317317318,-0.23641184268669907,Rep (McCain),Rep (Romney),4
kentucky,clinton,3366,761,0,4127,3569,752,72,4393,10161,-0.6312091107341895,-0.6519324230502198,Rep (McCain),Rep (Romney),3
kentucky,owen,2969,1694,0,4663,2971,1501,83,4555,10928,-0.2734291228822646,-0.3287119856887299,Rep (McCain),Rep (Romney),3
kentucky,hardin,23896,15650,0,39546,23357,15214,641,39212,100876,-0.2085166641379659,-0.21111716056104327,Rep (McCain),Rep (Romney),9
kentucky,jefferson,153865,196272,0,350137,148415,186164,4921,339500,729452,0.1211154490956397,0.11282537158638169,Dem (Obama),Dem (Obama),10
kentucky,leslie,3574,766,0,4340,4439,433,78,4950,11470,-0.6470046082949309,-0.8222495894909688,Rep (McCain),Rep (Romney),3
kentucky,mercer,6781,3159,0,9940,6820,2966,150,9936,21272,-0.3643863179074447,-0.39382791743306766,Rep (McCain),Rep (Romney),5
kentucky,todd,3336,1543,0,4879,3247,1403,68,4718,12307,-0.3674933387989342,-0.3965591397849462,Rep (McCain),Rep (Romney),3
kentucky,pulaski,19862,5590,0,25452,20714,4976,313,26003,62062,-0.5607417884645607,-0.6126119112495134,Rep (McCain),Rep (Romney),8
kentucky,metcalfe,2734,1350,0,4084,2676,1425,83,4184,10130,-0.3388834476003918,-0.30504754937820044,Rep (McCain),Rep (Romney),3
kentucky,boyd,11429,8886,0,20315,10883,7776,381,19040,49330,-0.1251784395766675,-0.16651481858620504,Rep (McCain),Rep (Romney),7
kentucky,fleming,3432,2279,0,5711,3780,1911,91,5782,14318,-0.20189108737524075,-0.3284132841328413,Rep (McCain),Rep (Romney),4
kentucky,floyd,7741,7530,0,15271,9784,4733,373,14890,39949,-0.01381703883177264,-0.34793690156368395,Rep (McCain),Rep (Romney),7
kentucky,cumberland,2056,697,0,2753,2216,599,38,2853,6931,-0.4936432982201235,-0.5744227353463588,Rep (McCain),Rep (Romney),2
kentucky,ohio,5781,4059,0,9840,6470,2987,189,9646,23837,-0.175,-0.36829861478270065,Rep (McCain),Rep (Romney),5
kentucky,caldwell,3866,2212,0,6078,3904,1852,104,5860,12934,-0.2721289897992761,-0.35649756775538566,Rep (McCain),Rep (Romney),3
kentucky,wayne,4868,2201,0,7069,5289,1855,66,7210,20716,-0.3772810864337247,-0.48068309070548715,Rep (McCain),Rep (Romney),5
kentucky,boyle,7697,4764,0,12461,7703,4471,194,12368,28245,-0.23537436802824813,-0.26548381797272874,Rep (McCain),Rep (Romney),6
kentucky,hopkins,11916,7104,0,19020,13681,5789,295,19765,46886,-0.25299684542586753,-0.40534155110426295,Rep (McCain),Rep (Romney),7
kentucky,franklin,11911,11767,0,23678,11345,11535,457,23337,49067,-0.006081594729284568,0.008304195804195804,Rep (McCain),Dem (Obama),7
kentucky,montgomery,5947,4234,0,10181,6398,3701,149,10248,25908,-0.16825459188684805,-0.26705614417269036,Rep (McCain),Rep (Romney),5
kentucky,casey,4679,1219,0,5898,4904,1086,101,6091,15939,-0.5866395388267209,-0.6373956594323873,Rep (McCain),Rep (Romney),4
kentucky,christian,13515,8822,0,22337,13475,8252,226,21953,72678,-0.21009983435555357,-0.24039213881345792,Rep (McCain),Rep (Romney),8
kentucky,lawrence,3503,2036,0,5539,3995,1520,77,5592,15841,-0.2648492507672865,-0.4487760652765186,Rep (McCain),Rep (Romney),4
kentucky,mccreary,4078,1258,0,5336,4564,1069,71,5704,18122,-0.5284857571214393,-0.6204509142552814,Rep (McCain),Rep (Romney),4
kentucky,boone,33812,16292,0,50104,35920,15628,947,52495,114723,-0.3496726808238863,-0.3936525180414371,Rep (McCain),Rep (Romney),9
kentucky,carter,5252,4314,0,9566,5279,3383,244,8906,27821,-0.09805561363161196,-0.2188870930501039,Rep (McCain),Rep (Romney),6
kentucky,hancock,1924,2128,0,4052,2212,1833,88,4133,8555,0.050345508390918066,-0.09369592088998764,Dem (Obama),Rep (Romney),2
kentucky,lyon,2220,1577,0,3797,2412,1373,53,3838,8367,-0.16934421912035819,-0.27450462351387056,Rep (McCain),Rep (Romney),2
kentucky,hart,4397,2290,0,6687,4256,2283,82,6621,18201,-0.31508897861522356,-0.30172809298057807,Rep (McCain),Rep (Romney),4
kentucky,marion,3842,3596,0,7438,3800,3418,98,7316,19619,-0.033073406829792956,-0.052923247436963146,Rep (McCain),Rep (Romney),5
kentucky,daviess,23692,19282,0,42974,25092,16208,779,42079,95398,-0.10262018895145902,-0.2151089588377724,Rep (McCain),Rep (Romney),9
kentucky,magoffin,2434,2105,0,4539,3391,1433,81,4905,13294,-0.07248292575457149,-0.4058872305140962,Rep (McCain),Rep (Romney),3
kentucky,garrard,5117,2012,0,7129,5310,1661,106,7077,16842,-0.435544957217001,-0.5234543107158227,Rep (McCain),Rep (Romney),4
kentucky,barren,11133,5434,0,16567,10922,5400,243,16565,41685,-0.3439971026739905,-0.33831638279622595,Rep (McCain),Rep (Romney),7
kentucky,harlan,7165,2586,0,9751,8653,1830,175,10658,29688,-0.46959286227053637,-0.6508633024897453,Rep (McCain),Rep (Romney),6
kentucky,marshall,9463,5593,0,15056,10402,5022,290,15714,31386,-0.2570403825717322,-0.3488070539419087,Rep (McCain),Rep (Romney),6
kentucky,carroll,2032,1716,0,3748,1999,1629,52,3680,10703,-0.08431163287086446,-0.1019845644983462,Rep (McCain),Rep (Romney),3
kentucky,taylor,7568,3165,0,10733,7551,3284,111,10946,24247,-0.41023013137053943,-0.39381633594831567,Rep (McCain),Rep (Romney),5
kentucky,woodford,7130,5027,0,12157,7218,4883,230,12331,24523,-0.17298675660113516,-0.19295925956532517,Rep (McCain),Rep (Romney),5
kentucky,washington,3305,1890,0,5195,3495,1669,54,5218,11593,-0.27237728585178056,-0.35360185902401237,Rep (McCain),Rep (Romney),3
kentucky,bath,2234,2210,0,4444,2275,1770,77,4122,11565,-0.0054005400540054005,-0.12484548825710753,Rep (McCain),Rep (Romney),3
kentucky,bell,9519,2718,0,12237,7127,2224,131,9482,28793,-0.5557734738906595,-0.524328948775532,Rep (McCain),Rep (Romney),6
kentucky,elliott,902,1535,0,2437,1126,1186,87,2399,7493,0.25974558883873616,0.025951557093425604,Dem (Obama),Dem (Obama),2
kentucky,rockcastle,4757,1410,0,6167,5028,1097,91,6216,17075,-0.542727420139452,-0.641795918367347,Rep (McCain),Rep (Romney),4
kentucky,johnson,5964,2413,0,8377,7095,1723,217,9035,23325,-0.4238987704428793,-0.6092084372873667,Rep (McCain),Rep (Romney),5
kentucky,fayette,59884,66040,0,125924,60793,62078,2950,125821,288045,0.048886630030812235,0.01045812274662044,Dem (Obama),Dem (Obama),10
kentucky,green,3785,1204,0,4989,3634,1165,57,4856,11377,-0.5173381439166166,-0.5144821837882892,Rep (McCain),Rep (Romney),3
kentucky,edmonson,3562,1652,0,5214,3232,1374,58,4664,12086,-0.36632144227080937,-0.40338688666956146,Rep (McCain),Rep (Romney),3
kentucky,union,3120,2804,0,5924,3952,1941,82,5975,15077,-0.053342336259284265,-0.34125233327676907,Rep (McCain),Rep (Romney),4
kentucky,adair,5512,1888,0,7400,5841,1660,99,7600,18542,-0.4897297297297297,-0.5573923476869751,Rep (McCain),Rep (Romney),4
kentucky,bourbon,4820,3385,0,8205,4692,3075,142,7909,19947,-0.1748933577087142,-0.2081884897643878,Rep (McCain),Rep (Romney),5
kentucky,grayson,6605,3154,0,9759,6404,2744,121,9269,25540,-0.35362229736653344,-0.40008745080892,Rep (McCain),Rep (Romney),5
kentucky,lincoln,6273,2752,0,9025,6416,2582,154,9152,24779,-0.39013850415512463,-0.42609468770837966,Rep (McCain),Rep (Romney),5
louisiana,tensas,1367,1646,0,3013,1230,1564,18,2812,5430,0.09259873879853966,0.11954187544738726,Dem (Obama),Dem (Obama),2
louisiana,rapides,36605,20109,0,56714,37187,20040,781,58008,130800,-0.29086292626159327,-0.2996312929211736,Rep (McCain),Rep (Romney),9
louisiana,beauregard,10718,3071,0,13789,11111,2827,285,14223,35000,-0.5545724853143811,-0.5943463911608552,Rep (McCain),Rep (Romney),6
louisiana,stmartin,14443,9419,0,23862,15653,9419,358,25430,51721,-0.21054396110971418,-0.2486439055520102,Rep (McCain),Rep (Romney),7
louisiana,stjohnthebaptist,8908,12420,0,21328,7620,13178,324,21122,46728,0.1646661665416354,0.2672372343494567,Dem (Obama),Dem (Obama),7
louisiana,lincoln,10676,8267,0,18943,10731,7947,296,18974,45797,-0.12717098664414295,-0.14905236106649533,Rep (McCain),Rep (Romney),7
louisiana,franklin,6278,2959,0,9237,6294,2921,121,9336,20727,-0.3593157951715925,-0.3660336408030385,Rep (McCain),Rep (Romney),5
louisiana,eastbatonrouge,95297,99431,0,194728,92235,102460,3217,197912,435815,0.0212296125878148,0.05251804103854747,Dem (Obama),Dem (Obama),10
louisiana,terrebonne,28208,11579,0,39787,29500,12071,764,42335,111131,-0.41795058687510994,-0.41925861778643764,Rep (McCain),Rep (Romney),9
louisiana,tangipahoa,31421,16427,0,47848,31583,17720,787,50090,118190,-0.31336732987794685,-0.28117964424071556,Rep (McCain),Rep (Romney),9
louisiana,calcasieu,50431,30227,0,80658,51844,28357,1517,81718,189134,-0.2504897220362518,-0.292851710078428,Rep (McCain),Rep (Romney),9
louisiana,bienville,3776,3589,0,7365,3641,3490,72,7203,14546,-0.025390359809911743,-0.021175150750245408,Rep (McCain),Rep (Romney),4
louisiana,bossier,32706,12701,0,45407,34986,12955,618,48559,113837,-0.440570837095602,-0.45954402286143387,Rep (McCain),Rep (Romney),9
louisiana,plaquemines,6889,3378,0,10267,6469,3597,169,10235,22710,-0.34196941657738383,-0.2853169084045301,Rep (McCain),Rep (Romney),5
louisiana,stcharles,16456,8519,0,24975,15936,8894,500,25330,52645,-0.3177977977977978,-0.2836085380587998,Rep (McCain),Rep (Romney),8
louisiana,natchitoches,9054,7801,0,16855,9077,7941,239,17257,39274,-0.07433995846929695,-0.06675284992361029,Rep (McCain),Rep (Romney),7
louisiana,jackson,5190,2456,0,7646,5132,2305,92,7529,16078,-0.35757258697358096,-0.3801263950517682,Rep (McCain),Rep (Romney),4
louisiana,cameron,3089,613,0,3702,3260,408,76,3744,7280,-0.668827660723933,-0.777535441657579,Rep (McCain),Rep (Romney),2
louisiana,sttammany,83047,24589,0,107636,84710,25723,2451,112884,228894,-0.5431082537441004,-0.5341428739597766,Rep (McCain),Rep (Romney),10
louisiana,sthelena,2522,3567,0,6089,2756,4233,104,7093,11125,0.17162095582197406,0.21133209328945485,Dem (Obama),Dem (Obama),3
louisiana,assumption,5981,4756,0,10737,6082,4754,155,10991,23487,-0.11409145943932197,-0.12255444813584349,Rep (McCain),Rep (Romney),5
louisiana,iberia,20123,12492,0,32615,20890,12129,373,33392,73395,-0.23397209872757935,-0.26533208152881677,Rep (McCain),Rep (Romney),8
louisiana,stlandry,21647,20267,0,41914,21475,19668,504,41647,84309,-0.032924559812950324,-0.04391998638893615,Rep (McCain),Rep (Romney),8
louisiana,redriver,2484,2080,0,4564,2483,2253,71,4807,9181,-0.08851884312007012,-0.048564189189189186,Rep (McCain),Rep (Romney),2
louisiana,stmary,13181,9342,0,22523,13883,9448,305,23636,54348,-0.17044798650268614,-0.1900904376151901,Rep (McCain),Rep (Romney),8
louisiana,caldwell,3696,1118,0,4814,3640,1016,60,4716,10188,-0.5355213959285418,-0.563573883161512,Rep (McCain),Rep (Romney),3
louisiana,allen,6333,2891,0,9224,6495,2616,195,9306,25816,-0.3731569817866435,-0.42574909450115245,Rep (McCain),Rep (Romney),5
louisiana,sabine,7226,2245,0,9471,7735,2194,121,10050,24119,-0.5259212332383064,-0.5580622419176151,Rep (McCain),Rep (Romney),5
louisiana,morehouse,7258,5789,0,13047,6591,5887,135,12613,28388,-0.11259293324135816,-0.05641929796441737,Rep (McCain),Rep (Romney),6
louisiana,caddo,52105,55220,0,107325,52378,57879,1259,111516,253048,0.029023992546005125,0.049892523830686486,Dem (Obama),Dem (Obama),10
louisiana,orleans,28041,116042,0,144083,27967,126199,3067,157233,295285,0.6107660168097555,0.6371832959277661,Dem (Obama),Dem (Obama),10
louisiana,desoto,6882,5241,0,12123,7353,5552,145,13050,26465,-0.13536253402623113,-0.13955831073227432,Rep (McCain),Rep (Romney),6
louisiana,lafayette,62055,32145,0,94200,64989,31766,1882,98637,215581,-0.31751592356687897,-0.3433724355330474,Rep (McCain),Rep (Romney),10
louisiana,ascension,31225,14620,0,45845,33846,16343,867,51056,102501,-0.3621987130548588,-0.3487417561617087,Rep (McCain),Rep (Romney),9
louisiana,washington,12215,6122,0,18337,11470,6351,279,18100,46578,-0.3322789987457054,-0.28724538465854893,Rep (McCain),Rep (Romney),7
louisiana,ouachita,41708,24769,0,66477,40927,26629,881,68437,152207,-0.25480993426297815,-0.21164663390372432,Rep (McCain),Rep (Romney),9
louisiana,grant,6906,1474,0,8380,7082,1421,163,8666,21675,-0.6482100238663484,-0.665765024109138,Rep (McCain),Rep (Romney),5
louisiana,westbatonrouge,6654,5043,0,11697,6920,5692,160,12772,23274,-0.1377276224672993,-0.09736758642562639,Rep (McCain),Rep (Romney),5
louisiana,stjames,5432,6993,0,12425,5209,7055,127,12391,22096,0.1256338028169014,0.1505218525766471,Dem (Obama),Dem (Obama),5
louisiana,eastfeliciana,5431,4383,0,9814,5397,4648,164,10209,20417,-0.10678622376197269,-0.07456445993031359,Rep (McCain),Rep (Romney),5
louisiana,vermilion,18069,6261,0,24330,18909,5718,357,24984,57280,-0.48532675709001233,-0.5356316238275064,Rep (McCain),Rep (Romney),8
louisiana,richland,5751,3311,0,9062,7316,4074,117,11507,20692,-0.26925623482674904,-0.28463564530289726,Rep (McCain),Rep (Romney),5
louisiana,vernon,11946,3534,0,15480,12146,3173,287,15606,50451,-0.5434108527131783,-0.5857431947255043,Rep (McCain),Rep (Romney),7
louisiana,evangeline,9792,5852,0,15644,10176,5330,259,15765,34419,-0.25185374584505243,-0.3125241841867664,Rep (McCain),Rep (Romney),6
louisiana,livingston,43247,6674,0,49921,45488,7448,1097,54033,122798,-0.7326175357064162,-0.7186035967961312,Rep (McCain),Rep (Romney),9
louisiana,acadia,19228,7028,0,26256,19931,6559,344,26834,61139,-0.46465569774527726,-0.5047942619856549,Rep (McCain),Rep (Romney),8
louisiana,webster,11417,6610,0,18027,11397,6802,214,18413,41238,-0.26665557219725966,-0.2524864003516677,Rep (McCain),Rep (Romney),7
louisiana,iberville,7185,9023,0,16208,7271,9548,195,17014,33513,0.11340078973346496,0.1353826030085023,Dem (Obama),Dem (Obama),6
louisiana,eastcarroll,1254,2267,0,3521,1122,2244,18,3384,7964,0.28770235728486226,0.3333333333333333,Dem (Obama),Dem (Obama),2
louisiana,avoyelles,10234,6327,0,16561,10667,6075,285,17027,42013,-0.23591570557333494,-0.2742802532552861,Rep (McCain),Rep (Romney),7
louisiana,jeffersondavis,9277,3923,0,13200,10014,3483,236,13733,31500,-0.4056060606060606,-0.48388530784618805,Rep (McCain),Rep (Romney),6
louisiana,lasalle,5601,860,0,6461,5726,764,82,6572,14680,-0.7337873394211423,-0.7645608628659476,Rep (McCain),Rep (Romney),4
louisiana,westcarroll,4045,878,0,4923,3628,853,67,4548,11689,-0.6433069266707292,-0.6192814103994644,Rep (McCain),Rep (Romney),3
louisiana,jefferson,113008,64853,0,177861,102325,70000,3408,175733,431019,-0.2707451324348789,-0.18758160452633105,Rep (McCain),Rep (Romney),10
louisiana,catahoula,3486,1659,0,5145,2744,1408,41,4193,10465,-0.3551020408163265,-0.3217726396917148,Rep (McCain),Rep (Romney),3
louisiana,lafourche,27089,9662,0,36751,28332,9543,850,38725,95428,-0.47419117847133413,-0.4960792079207921,Rep (McCain),Rep (Romney),9
louisiana,claiborne,3750,3025,0,6775,3649,3014,69,6732,17160,-0.1070110701107011,-0.09530241632898094,Rep (McCain),Rep (Romney),4
louisiana,pointecoupee,6702,5516,0,12218,6548,5436,163,12147,22837,-0.09706989687346537,-0.09279038718291055,Rep (McCain),Rep (Romney),5
louisiana,westfeliciana,3149,2414,0,5563,3257,2441,79,5777,15681,-0.13212295523997844,-0.1432081432081432,Rep (McCain),Rep (Romney),4
louisiana,union,7619,3103,0,10722,7561,3075,130,10766,22750,-0.421190076478269,-0.4217751034223392,Rep (McCain),Rep (Romney),5
louisiana,stbernard,9642,3491,0,13133,8497,5052,395,13944,27739,-0.4683621411710957,-0.2542623071813418,Rep (McCain),Rep (Romney),6
louisiana,madison,2152,3100,0,5252,2000,3154,33,5187,12286,0.1805026656511805,0.22390376406674428,Dem (Obama),Dem (Obama),3
louisiana,concordia,5668,3766,0,9434,5450,3833,97,9380,20502,-0.20161119355522578,-0.174189378433696,Rep (McCain),Rep (Romney),5
louisiana,winn,4628,2044,0,6672,4539,1919,74,6532,15477,-0.3872901678657074,-0.4056983586249613,Rep (McCain),Rep (Romney),4
maine,hancock,12667,18863,0,31530,12398,17533,807,30738,54309,0.19651125911830003,0.1715612575590525,Dem (Obama),Dem (Obama),8
maine,york,38405,59449,0,97854,43879,61492,2256,107627,197457,0.2150550820610297,0.16715225251729604,Dem (Obama),Dem (Obama),10
maine,waldo,8204,9269,0,17473,9055,11292,629,20976,38740,0.06095118182338465,0.10994249766550351,Dem (Obama),Dem (Obama),7
maine,oxford,11867,16526,0,28393,11766,16052,916,28734,57867,0.16408974042897898,0.15407290243727084,Dem (Obama),Dem (Obama),8
maine,sagadahoc,5272,7601,0,12873,8429,11821,484,20734,35688,0.18092130816437504,0.16750617283950617,Dem (Obama),Dem (Obama),6
maine,penobscot,37143,42668,0,79811,36592,38816,1763,77171,152934,0.06922604653493879,0.029492892000848717,Dem (Obama),Dem (Obama),9
maine,washington,8070,8241,0,16311,7539,7797,420,15756,33154,0.010483722641162405,0.016823161189358372,Dem (Obama),Dem (Obama),6
maine,piscataquis,4785,4430,0,9215,4577,4168,245,8990,17555,-0.0385241454150841,-0.04676958261863922,Rep (McCain),Rep (Romney),4
maine,androscoggin,22597,30635,0,53232,22210,28912,1417,52539,107882,0.15099939885782987,0.1310981573490865,Dem (Obama),Dem (Obama),9
maine,kennebec,23204,32222,0,55426,26506,35022,1697,63225,121925,0.16270342438566737,0.1384085294500065,Dem (Obama),Dem (Obama),9
maine,cumberland,50277,95512,0,145789,57008,100977,8910,166895,279994,0.3102771814060046,0.27831123207899483,Dem (Obama),Dem (Obama),10
maine,somerset,10854,12516,0,23370,11798,12211,696,24705,52261,0.07111681643132221,0.017201882627348078,Dem (Obama),Dem (Obama),8
maine,knox,8197,12849,0,21046,8262,13227,513,22002,40111,0.22103962748265704,0.2310484433896412,Dem (Obama),Dem (Obama),7
maine,franklin,6283,9726,0,16009,6305,9292,515,16112,30657,0.2150665250796427,0.1915111880489838,Dem (Obama),Dem (Obama),6
maine,lincoln,8316,10542,0,18858,8884,11298,486,20668,34719,0.11804008908685969,0.11961153503121594,Dem (Obama),Dem (Obama),6
maine,aroostook,15735,19098,0,34833,15229,17844,793,33866,72412,0.0965463784342434,0.0790675173101926,Dem (Obama),Dem (Obama),8
maryland,talbot,9599,7702,0,17301,10442,7983,246,18671,37361,-0.10964684122305068,-0.13345997286295794,Rep (McCain),Rep (Romney),7
maryland,calvert,21089,18382,0,39471,22413,18963,792,42168,87891,-0.06858199690912316,-0.08338167053364269,Rep (McCain),Rep (Romney),8
maryland,dorchester,7510,6272,0,13782,7514,6570,165,14249,32287,-0.0898273109853432,-0.06702641295086623,Rep (McCain),Rep (Romney),6
maryland,wicomico,19823,17455,0,37278,20136,17481,639,38256,96951,-0.06352272117602875,-0.07057979105191801,Rep (McCain),Rep (Romney),9
maryland,howard,50447,77800,0,128247,54094,84017,3056,141167,279366,0.2132837415300163,0.2166590640861336,Dem (Obama),Dem (Obama),10
maryland,baltimorecity,26131,197262,0,223393,25501,201042,3354,229897,620538,0.7660535468882194,0.7748683472894771,Dem (Obama),Dem (Obama),10
maryland,cecil,22315,16331,0,38646,23660,15489,888,40037,100139,-0.15484138073798065,-0.20871542057268386,Rep (McCain),Rep (Romney),9
maryland,harford,66507,44479,0,110986,69496,46390,2531,118417,242888,-0.198475483394302,-0.19938560309269454,Rep (McCain),Rep (Romney),10
maryland,frederick,51145,48842,0,99987,55495,51187,2445,109127,229205,-0.023032994289257605,-0.04038169513132487,Rep (McCain),Rep (Romney),10
maryland,carroll,51308,25798,0,77106,53960,26067,2144,82171,167208,-0.33084325474022774,-0.34854486610768864,Rep (McCain),Rep (Romney),9
maryland,washington,31715,23953,0,55668,34113,23282,1258,58653,146329,-0.13943378601710138,-0.18870981792839098,Rep (McCain),Rep (Romney),9
maryland,annearundel,119956,113963,0,233919,118165,115960,5064,239189,527020,-0.025619979565576118,-0.009418045915643353,Rep (McCain),Rep (Romney),10
maryland,caroline,7528,4538,0,12066,7674,4621,231,12526,32805,-0.24780374606331843,-0.2483123220821472,Rep (McCain),Rep (Romney),6
maryland,baltimore,145991,190991,0,336982,144686,202733,7236,354655,799195,0.13353828987898464,0.16708067204154062,Dem (Obama),Dem (Obama),10
maryland,worcester,13787,10037,0,23824,14334,9841,351,24526,51133,-0.15740429818670248,-0.18585315408479836,Rep (McCain),Rep (Romney),7
maryland,somerset,4622,4356,0,8978,4706,4478,88,9272,26411,-0.029627979505457785,-0.024825783972125436,Rep (McCain),Rep (Romney),6
maryland,princegeorges,29269,247464,0,276733,32236,317342,2714,352292,854722,0.7884675842779864,0.8155719181413018,Dem (Obama),Dem (Obama),10
maryland,kent,4401,4397,0,8798,4533,4453,157,9143,20018,-4.546487838145033e-4,-0.00890273759180948,Rep (McCain),Rep (Romney),5
maryland,stmarys,22531,17056,0,39587,25096,17982,998,44076,102086,-0.13830297825043575,-0.1651423000139282,Rep (McCain),Rep (Romney),9
maryland,queenannes,13715,7704,0,21419,14879,7898,376,23153,46945,-0.2806386852794248,-0.3064933924573034,Rep (McCain),Rep (Romney),7
maryland,montgomery,105088,271132,0,376220,110940,286493,6781,404214,947230,0.4413481473605869,0.4417172202610251,Dem (Obama),Dem (Obama),10
maryland,garrett,8209,3285,0,11494,9102,2792,219,12113,30145,-0.42839742474334436,-0.5305195897090971,Rep (McCain),Rep (Romney),6
maryland,charles,23441,40127,0,63568,23637,45621,909,70167,143912,0.26249056128869874,0.3174218140864593,Dem (Obama),Dem (Obama),9
maryland,allegany,17193,9824,0,27017,18158,9001,658,27817,74638,-0.2727541918051597,-0.3371626348540079,Rep (McCain),Rep (Romney),8
massachusetts,suffolk,55142,202148,0,257290,58872,219208,4569,282649,704460,0.5713630533639085,0.5765822784810126,Dem (Obama),Dem (Obama),10
massachusetts,nantucket,1863,4059,0,5922,2185,3828,84,6097,10069,0.3708206686930091,0.2732413104939298,Dem (Obama),Dem (Obama),3
massachusetts,middlesex,245215,462226,0,707441,266307,467173,13376,746856,1479491,0.3067549095967014,0.2738534111359546,Dem (Obama),Dem (Obama),10
massachusetts,dukes,2438,7892,0,10330,2789,7955,170,10914,16155,0.5279767666989351,0.4808265078183172,Dem (Obama),Dem (Obama),4
massachusetts,berkshire,14851,49415,0,64266,14209,48596,1273,64078,131528,0.5378271558833598,0.5475201019027147,Dem (Obama),Dem (Obama),9
massachusetts,hampshire,20569,56847,0,77416,21366,56552,2488,80406,157326,0.4686111398160587,0.4515772992119921,Dem (Obama),Dem (Obama),9
massachusetts,bristol,90284,146311,0,236595,93448,142481,3636,239565,546433,0.2368055115281388,0.20782947412145178,Dem (Obama),Dem (Obama),10
massachusetts,plymouth,112681,131457,0,244138,119833,129577,2986,252396,490784,0.07690732290753591,0.039068200954252036,Dem (Obama),Dem (Obama),10
massachusetts,worcester,151742,201230,0,352972,162022,195667,6404,364093,791855,0.14020375553868294,0.09406216014470671,Dem (Obama),Dem (Obama),10
massachusetts,barnstable,55570,73503,0,129073,60221,70329,1662,132212,217483,0.13893688067992532,0.07742627345844504,Dem (Obama),Dem (Obama),10
massachusetts,norfolk,136573,199833,0,336406,144654,200891,4650,350195,662077,0.18804658656504342,0.1627487013268894,Dem (Obama),Dem (Obama),10
massachusetts,hampden,70923,120021,0,190944,72318,122571,2938,197827,462270,0.25713298139768725,0.257854471006573,Dem (Obama),Dem (Obama),10
massachusetts,franklin,9330,26918,0,36248,9338,27024,1238,37600,71523,0.48521297726771134,0.48638688740993347,Dem (Obama),Dem (Obama),8
massachusetts,essex,136905,208323,0,345228,149808,208723,4715,363246,735642,0.20687198025652612,0.16432330816582108,Dem (Obama),Dem (Obama),10
michigan,newaygo,11862,10788,0,22650,12458,8723,243,21424,48962,-0.047417218543046355,-0.17633728341438082,Rep (McCain),Rep (Romney),7
michigan,huron,8434,8367,0,16801,8686,6432,156,15274,33642,-0.0039878578656032376,-0.149093795475592,Rep (McCain),Rep (Romney),6
michigan,emmet,9315,8515,0,17830,10253,7225,194,17672,32806,-0.044868199663488505,-0.17324636686119693,Rep (McCain),Rep (Romney),6
michigan,antrim,7506,6079,0,13585,7917,5107,160,13184,23975,-0.10504232609495767,-0.21575552825552827,Rep (McCain),Rep (Romney),5
michigan,alcona,3404,2896,0,6300,3571,2462,53,6086,11238,-0.08063492063492063,-0.1838223106248964,Rep (McCain),Rep (Romney),3
michigan,wexford,8044,7357,0,15401,7972,5717,170,13859,32653,-0.04460749301993377,-0.16473080575644677,Rep (McCain),Rep (Romney),6
michigan,midland,22285,20742,0,43027,23942,17480,386,41808,83626,-0.035861203430404165,-0.15600405581575008,Rep (McCain),Rep (Romney),8
michigan,lenawee,22223,24638,0,46861,22351,21774,494,44619,100911,0.05153539190371524,-0.013076487252124645,Dem (Obama),Rep (Romney),9
michigan,berrien,36128,40376,0,76504,38209,33465,648,72322,157232,0.055526508417860505,-0.06618857605268298,Dem (Obama),Rep (Romney),9
michigan,crawford,3558,3440,0,6998,3744,2994,76,6814,14325,-0.016861960560160046,-0.11130899376669635,Rep (McCain),Rep (Romney),4
michigan,osceola,5966,4848,0,10814,6140,3981,144,10265,23681,-0.10338450157203626,-0.21331884201165893,Rep (McCain),Rep (Romney),5
michigan,iron,2947,3080,0,6027,3224,2687,76,5987,12057,0.022067363530778164,-0.09084757232278802,Dem (Obama),Rep (Romney),3
michigan,branch,9534,8412,0,17946,9575,6526,177,16278,46083,-0.06252089602139753,-0.189367120054655,Rep (McCain),Rep (Romney),7
michigan,oceana,5860,6405,0,12265,6239,5063,136,11438,27029,0.04443538524256013,-0.1040523801097151,Dem (Obama),Rep (Romney),6
michigan,muskegon,28855,53400,0,82255,30882,44436,736,76054,173223,0.29840131299009176,0.1799569823946467,Dem (Obama),Dem (Obama),9
michigan,leelanau,6937,7354,0,14291,7483,6576,105,14164,21757,0.029179203694632987,-0.06451383455437798,Dem (Obama),Rep (Romney),5
michigan,eaton,25898,30736,0,56634,26193,27912,602,54707,108002,0.0854257160009888,0.03177155530912115,Dem (Obama),Dem (Obama),9
michigan,montmorency,2841,2403,0,5244,2928,2049,74,5051,9920,-0.08352402745995423,-0.17661241711874623,Rep (McCain),Rep (Romney),3
michigan,hillsdale,11221,8765,0,19986,11727,7106,248,19081,47033,-0.1228860202141499,-0.24536717464025912,Rep (McCain),Rep (Romney),7
michigan,kalamazoo,48411,73407,0,121818,52660,69045,1175,122880,247246,0.20519135103186723,0.1346288155786533,Dem (Obama),Dem (Obama),10
michigan,clare,6793,7496,0,14289,6988,6337,167,13492,31162,0.0491986843026104,-0.048855534709193245,Dem (Obama),Rep (Romney),6
michigan,gladwin,6391,6590,0,12981,6661,5760,131,12552,26076,0.015330097835297743,-0.07253844295950407,Dem (Obama),Rep (Romney),6
michigan,vanburen,15535,18589,0,34124,16140,16288,370,32798,76585,0.08949712812097058,0.0045639570741334646,Dem (Obama),Dem (Obama),8
michigan,iosco,6583,7307,0,13890,6906,6242,182,13330,26422,0.05212383009359251,-0.050501977487070276,Dem (Obama),Rep (Romney),6
michigan,alpena,7125,7705,0,14830,7298,6549,167,14014,29958,0.03910991233985165,-0.05409113887484654,Dem (Obama),Rep (Romney),6
michigan,houghton,8100,7473,0,15573,8040,6530,234,14804,36192,-0.0402619919090734,-0.10363761153054221,Rep (McCain),Rep (Romney),6
michigan,delta,8763,9976,0,18739,9533,8330,180,18043,37403,0.06473130903463366,-0.06734591054134244,Dem (Obama),Rep (Romney),7
michigan,cheboygan,6919,6721,0,13640,7284,5829,175,13288,26699,-0.014516129032258065,-0.11095859071150767,Rep (McCain),Rep (Romney),6
michigan,calhoun,28538,34550,0,63088,28338,29270,623,58231,137112,0.09529546030940908,0.016178308568254408,Dem (Obama),Dem (Obama),9
michigan,alger,2188,2472,0,4660,2329,2212,62,4603,9604,0.06094420600858369,-0.025765249944946046,Dem (Obama),Rep (Romney),3
michigan,gratiot,8324,9102,0,17426,8236,7606,169,16011,42612,0.04464593136692299,-0.03976770609771493,Dem (Obama),Rep (Romney),7
michigan,menominee,4855,5980,0,10835,5565,5244,113,10922,24245,0.10383017997231195,-0.029697474326949764,Dem (Obama),Rep (Romney),5
michigan,washtenaw,53943,130547,0,184490,56401,120791,1824,179016,343947,0.41522033714564477,0.3633911237527654,Dem (Obama),Dem (Obama),10
michigan,marquette,12902,19630,0,32532,13609,18126,409,32144,66514,0.20681175458010576,0.1423349613990862,Dem (Obama),Dem (Obama),8
michigan,dickinson,7049,5995,0,13044,7688,4952,145,12785,26584,-0.0808034345292855,-0.21645569620253163,Rep (McCain),Rep (Romney),6
michigan,stjoseph,12876,12311,0,25187,12975,10106,233,23314,61848,-0.02243220709095962,-0.12430137342402842,Rep (McCain),Rep (Romney),8
michigan,bay,23794,32589,0,56383,23735,26797,545,51077,108156,0.15598673358991186,0.06059526636586717,Dem (Obama),Dem (Obama),9
michigan,charlevoix,7306,6817,0,14123,7997,5936,131,14064,26228,-0.03462437159243787,-0.14792219909567214,Rep (McCain),Rep (Romney),6
michigan,tuscola,13739,13503,0,27242,14517,11643,322,26482,56543,-0.008663093752294251,-0.10986238532110092,Rep (McCain),Rep (Romney),8
michigan,shiawassee,15054,18015,0,33069,15962,17197,431,33590,71621,0.08954005261725483,0.03724479025302331,Dem (Obama),Dem (Obama),8
michigan,jackson,35692,37480,0,73172,36298,32301,724,69323,161569,0.0244355764500082,-0.05826615548331608,Dem (Obama),Rep (Romney),9
michigan,mason,7146,7816,0,14962,7580,6856,152,14588,28715,0.04478010961101457,-0.05015239678581324,Dem (Obama),Rep (Romney),6
michigan,clinton,19724,20001,0,39725,20630,18187,308,39125,74235,0.00697293895531781,-0.06293634232423938,Dem (Obama),Rep (Romney),8
michigan,oakland,276881,372694,0,649575,296531,349055,4720,650306,1201113,0.14750105838432823,0.08135864160623062,Dem (Obama),Dem (Obama),10
michigan,monroe,35852,39180,0,75032,35593,36310,779,72682,152784,0.04435440878558482,0.009971767520131288,Dem (Obama),Dem (Obama),9
michigan,ontonagon,1823,1966,0,3789,1906,1585,44,3535,6976,0.03774082871470045,-0.09195073044972787,Dem (Obama),Rep (Romney),2
michigan,isabella,11220,16679,0,27899,10800,13038,281,24119,69451,0.1956700957023549,0.09388371507676818,Dem (Obama),Dem (Obama),8
michigan,presqueisle,3605,3719,0,7324,3794,3192,91,7077,13697,0.015565264882577826,-0.08617234468937876,Dem (Obama),Rep (Romney),3
michigan,roscommon,6727,7082,0,13809,6701,6198,133,13032,24932,0.02570787167789123,-0.03899527095123653,Dem (Obama),Rep (Romney),5
michigan,luce,1490,1191,0,2681,1501,951,25,2477,6685,-0.11152555016784782,-0.22430668841761828,Rep (McCain),Rep (Romney),2
michigan,benzie,4687,5461,0,10148,5071,4683,93,9847,17705,0.07627118644067797,-0.039778552388763586,Dem (Obama),Rep (Romney),4
michigan,cass,11112,12080,0,23192,12660,9587,214,22461,52429,0.04173853052776819,-0.13813098395289253,Dem (Obama),Rep (Romney),8
michigan,arenac,3807,4155,0,7962,4054,3669,103,7826,16487,0.04370761115297664,-0.04985109413440373,Dem (Obama),Rep (Romney),4
michigan,montcalm,13291,13208,0,26499,13624,11431,328,25383,63553,-0.003132193667685573,-0.08752743963280782,Rep (McCain),Rep (Romney),8
michigan,keweenaw,756,610,0,1366,774,582,32,1388,2122,-0.10688140556368961,-0.1415929203539823,Rep (McCain),Rep (Romney),1
michigan,allegan,29526,23526,0,53052,29023,19594,582,49199,111385,-0.1130965844831486,-0.1939445050085361,Rep (McCain),Rep (Romney),9
michigan,lapeer,22831,21457,0,44288,23725,18786,514,43025,89944,-0.03102420520231214,-0.11618169414974948,Rep (McCain),Rep (Romney),9
michigan,ingham,47143,95698,0,142841,45365,80903,1311,127579,281365,0.33992341134548204,0.281448981531346,Dem (Obama),Dem (Obama),10
michigan,gogebic,3330,4757,0,8087,3444,4058,74,7576,16471,0.17645604055892172,0.08184484137563316,Dem (Obama),Dem (Obama),4
michigan,missaukee,4469,2898,0,7367,4665,2274,85,7024,14962,-0.21324826930908103,-0.34457414613056636,Rep (McCain),Rep (Romney),4
michigan,saginaw,42218,60260,0,102478,42716,54372,815,97903,202336,0.17605730010343684,0.1200560316413975,Dem (Obama),Dem (Obama),10
michigan,ottawa,84823,51925,0,136748,88503,43068,1124,132695,261376,-0.2405739023605464,-0.3453268577422076,Rep (McCain),Rep (Romney),10
michigan,grandtraverse,24713,23255,0,47968,26532,20875,494,47901,86061,-0.030395263509006003,-0.11932836922817305,Rep (McCain),Rep (Romney),8
michigan,otsego,6752,5634,0,12386,7008,4681,140,11829,24445,-0.09026320038753431,-0.19907605441012918,Rep (McCain),Rep (Romney),5
michigan,mackinac,3268,3027,0,6295,3396,2652,49,6097,11281,-0.03828435266084194,-0.12301587301587301,Rep (McCain),Rep (Romney),3
michigan,stclair,38555,40676,0,79231,39076,33845,819,73740,165719,0.02676982494225745,-0.07173516545302451,Dem (Obama),Rep (Romney),9
michigan,schoolcraft,2058,2184,0,4242,2142,1865,39,4046,8640,0.0297029702970297,-0.06912902420763664,Dem (Obama),Rep (Romney),2
michigan,kent,148305,149855,0,298160,157801,134560,3057,295418,599432,0.005198551113496109,-0.0794941869811637,Dem (Obama),Rep (Romney),10
michigan,genesee,72445,143919,0,216364,71807,128972,1920,202699,433054,0.3303414616109889,0.2847160310590251,Dem (Obama),Dem (Obama),10
michigan,baraga,1846,1725,0,3571,1866,1574,50,3490,8882,-0.03388406608793055,-0.08488372093023255,Rep (McCain),Rep (Romney),2
michigan,kalkaska,4527,3780,0,8307,4897,3268,116,8281,17400,-0.08992416034669556,-0.19951010410287814,Rep (McCain),Rep (Romney),4
michigan,wayne,216880,656303,0,873183,213586,595253,5269,814108,1870362,0.5032427337682936,0.4718701744104822,Dem (Obama),Dem (Obama),10
michigan,ogemaw,5133,5391,0,10524,5437,4791,133,10361,21862,0.02451539338654504,-0.06315995307000391,Dem (Obama),Rep (Romney),5
michigan,ionia,15850,14808,0,30658,14319,11016,395,25730,64651,-0.033987866136081936,-0.13037300177619893,Rep (McCain),Rep (Romney),8
michigan,sanilac,10678,9047,0,19725,10961,7212,186,18359,44010,-0.08268694550063371,-0.20629505310075386,Rep (McCain),Rep (Romney),7
michigan,oscoda,2320,1887,0,4207,2308,1654,65,4027,8884,-0.10292369859757547,-0.16506814740030287,Rep (McCain),Rep (Romney),2
michigan,macomb,187645,223754,0,411399,191896,207992,3500,403388,837490,0.08777123911336683,0.040251270355699593,Dem (Obama),Dem (Obama),10
michigan,chippewa,8249,8169,0,16418,8278,7100,186,15564,39078,-0.004872700694359849,-0.07660293926388347,Rep (McCain),Rep (Romney),7
michigan,livingston,55581,42346,0,97927,60000,37186,773,97959,181350,-0.13515169462967314,-0.23474574527195274,Rep (McCain),Rep (Romney),9
michigan,mecosta,9235,9099,0,18334,9175,7515,189,16879,42730,-0.007417912075924512,-0.09946075494307968,Rep (McCain),Rep (Romney),7
michigan,manistee,5506,7234,0,12740,5736,6467,182,12385,24951,0.13563579277864993,0.05990330246660657,Dem (Obama),Dem (Obama),5
michigan,barry,16431,13449,0,29880,16651,11496,336,28483,59576,-0.09979919678714859,-0.1831456283085231,Rep (McCain),Rep (Romney),8
michigan,lake,2269,2919,0,5188,2487,2752,48,5287,11625,0.12528912875867387,0.0505821721702615,Dem (Obama),Dem (Obama),3
minnesota,koochiching,2962,3649,0,6611,2841,3451,140,6432,13461,0.10391771290273787,0.09694850603941513,Dem (Obama),Dem (Obama),3
minnesota,blueearth,14782,19325,0,34107,14916,18164,959,34039,62719,0.13319846365848653,0.09818621523579202,Dem (Obama),Dem (Obama),8
minnesota,watonwan,2526,2561,0,5087,2517,2494,104,5115,11212,0.006880283074503637,-0.004589902215126721,Dem (Obama),Rep (Romney),3
minnesota,scott,36726,29209,0,65935,40321,29714,1376,71411,126139,-0.11400621824524153,-0.1514528450060684,Rep (McCain),Rep (Romney),9
minnesota,roseau,4437,3096,0,7533,4409,2772,149,7330,15864,-0.17801672640382318,-0.22796267929257763,Rep (McCain),Rep (Romney),4
minnesota,douglas,11241,9255,0,20496,11905,8665,347,20917,35909,-0.09689695550351288,-0.15751093825960136,Rep (McCain),Rep (Romney),6
minnesota,cottonwood,3157,2759,0,5916,3316,2433,99,5848,11712,-0.06727518593644355,-0.15359192903113586,Rep (McCain),Rep (Romney),3
minnesota,ramsey,88927,182950,0,271877,86799,184936,6047,277782,503113,0.34582918010718083,0.36114964947467204,Dem (Obama),Dem (Obama),10
minnesota,wadena,4127,2882,0,7009,4143,2492,137,6772,13809,-0.1776287630189756,-0.24883195177091183,Rep (McCain),Rep (Romney),3
minnesota,polk,7148,7849,0,14997,7615,6773,256,14644,31336,0.04674268186970727,-0.058520989713650266,Dem (Obama),Rep (Romney),6
minnesota,stearns,41194,35696,0,76890,43015,33552,1611,78178,147927,-0.07150474704122772,-0.12359110321679052,Rep (McCain),Rep (Romney),9
minnesota,olmsted,36202,38711,0,74913,36832,39338,1781,77951,141244,0.03349218426708315,0.032900091899698045,Dem (Obama),Dem (Obama),9
minnesota,lyon,6315,6110,0,12425,6595,5465,274,12334,25606,-0.016498993963782696,-0.09369817578772803,Rep (McCain),Rep (Romney),5
minnesota,wabasha,5935,5646,0,11581,6049,5415,258,11722,21743,-0.024954667127191087,-0.055303558967201676,Rep (McCain),Rep (Romney),5
minnesota,millelacs,7049,6073,0,13122,6951,5829,267,13047,26075,-0.07437890565462582,-0.08779342723004695,Rep (McCain),Rep (Romney),6
minnesota,lesueur,7636,6994,0,14630,7714,6753,263,14730,27719,-0.043882433356117564,-0.06642704085159327,Rep (McCain),Rep (Romney),6
minnesota,yellowmedicine,2579,2816,0,5395,2806,2465,126,5397,10514,0.04392956441149212,-0.06469360652627584,Dem (Obama),Rep (Romney),3
minnesota,sherburne,26131,17953,0,44084,27848,17597,875,46320,86823,-0.18550948189819436,-0.2255693695676092,Rep (McCain),Rep (Romney),8
minnesota,pope,3068,3317,0,6385,3142,2981,101,6224,11064,0.038997650743931085,-0.0262943001796505,Dem (Obama),Rep (Romney),3
minnesota,stlouis,38720,77232,0,115952,39675,74177,2608,116460,199472,0.33213743618048847,0.3030425464638302,Dem (Obama),Dem (Obama),10
minnesota,norman,1204,2129,0,3333,1384,1730,85,3199,6865,0.2775277527752775,0.1111111111111111,Dem (Obama),Dem (Obama),2
minnesota,kanabec,4479,3742,0,8221,4319,3586,202,8107,16379,-0.08964846125775452,-0.09272612270714738,Rep (McCain),Rep (Romney),4
minnesota,goodhue,12775,12420,0,25195,12986,12212,503,25701,45930,-0.014090097241516174,-0.030716723549488054,Rep (McCain),Rep (Romney),7
minnesota,stevens,2710,2780,0,5490,2766,2742,113,5621,9711,0.012750455373406194,-0.004357298474945534,Dem (Obama),Rep (Romney),3
minnesota,grant,1646,1850,0,3496,1748,1647,76,3471,6082,0.05835240274599542,-0.02974963181148748,Dem (Obama),Rep (Romney),2
minnesota,cook,1240,2019,0,3259,1221,1993,90,3304,5211,0.2390303774163854,0.24019912881144992,Dem (Obama),Dem (Obama),1
minnesota,rice,13723,17381,0,31104,14380,17054,726,32160,63087,0.11760545267489712,0.08506712476935802,Dem (Obama),Dem (Obama),8
minnesota,kandiyohi,11318,10123,0,21441,11239,9806,358,21403,41869,-0.055734340749032225,-0.06809218341648848,Rep (McCain),Rep (Romney),7
minnesota,clearwater,2291,1877,0,4168,2359,1753,71,4183,8593,-0.09932821497120921,-0.14737354085603113,Rep (McCain),Rep (Romney),2
minnesota,beltrami,9762,12019,0,21781,9637,11818,494,21949,43781,0.10362242321289197,0.10165462596131437,Dem (Obama),Dem (Obama),7
minnesota,itasca,10309,13461,0,23770,10500,12852,481,23833,44835,0.1326041228439209,0.10071942446043165,Dem (Obama),Dem (Obama),7
minnesota,steele,10068,9016,0,19084,9903,8706,425,19034,36434,-0.05512471180046112,-0.06432371433177494,Rep (McCain),Rep (Romney),6
minnesota,faribault,4197,3736,0,7933,4104,3407,178,7689,14819,-0.0581116853649313,-0.0927972307282652,Rep (McCain),Rep (Romney),4
minnesota,crowwing,18566,15859,0,34425,19415,14760,625,34800,61836,-0.07863471314451706,-0.13621068032187272,Rep (McCain),Rep (Romney),8
minnesota,marshall,2285,2311,0,4596,2380,1854,101,4335,9580,0.005657093124456049,-0.12423240434577232,Dem (Obama),Rep (Romney),3
minnesota,swift,2184,2907,0,5091,2248,2751,88,5087,9946,0.14201532115497936,0.10062012402480495,Dem (Obama),Dem (Obama),3
minnesota,mahnomen,843,1436,0,2279,871,1276,32,2179,5359,0.2602018429135586,0.18863530507685142,Dem (Obama),Dem (Obama),2
minnesota,clay,11978,16666,0,28644,12920,15210,641,28771,57089,0.16366429269655075,0.08140774973338073,Dem (Obama),Dem (Obama),8
minnesota,pennington,3248,3394,0,6642,3304,3024,165,6493,13862,0.021981330924420357,-0.04424778761061947,Dem (Obama),Rep (Romney),4
minnesota,kittson,1016,1492,0,2508,1095,1241,69,2405,4620,0.189792663476874,0.0625,Dem (Obama),Dem (Obama),1
minnesota,dakota,104361,116761,0,221122,109514,116252,4257,230023,393380,0.05607764039760856,0.02984506081518032,Dem (Obama),Dem (Obama),10
minnesota,chisago,15788,12782,0,28570,16227,12524,580,29331,52844,-0.10521526076303815,-0.12879552015582066,Rep (McCain),Rep (Romney),8
minnesota,wilkin,1786,1550,0,3336,1884,1258,70,3212,6636,-0.07074340527577938,-0.19923615531508593,Rep (McCain),Rep (Romney),2
minnesota,sibley,4492,2998,0,7490,4693,2916,176,7785,15219,-0.19946595460614153,-0.23353922985937706,Rep (McCain),Rep (Romney),4
minnesota,redwood,4308,3250,0,7558,4570,3008,183,7761,16069,-0.13998412278380523,-0.2061229875956717,Rep (McCain),Rep (Romney),4
minnesota,nicollet,7968,9887,0,17855,8214,9652,419,18285,32271,0.10747689722766732,0.08048807791335498,Dem (Obama),Dem (Obama),6
minnesota,houston,4743,5906,0,10649,4951,5281,190,10422,19226,0.10921213259460982,0.03225175918686474,Dem (Obama),Dem (Obama),5
minnesota,renville,3956,3904,0,7860,4149,3394,141,7684,16007,-0.0066157760814249365,-0.10009280127270317,Rep (McCain),Rep (Romney),4
minnesota,jackson,2858,2618,0,5476,3044,2268,103,5415,10403,-0.04382761139517896,-0.1460843373493976,Rep (McCain),Rep (Romney),3
minnesota,washington,64335,70281,0,134616,69137,70203,2371,141711,232536,0.04417008379390266,0.0076503516578154155,Dem (Obama),Dem (Obama),10
minnesota,anoka,91488,87098,0,178586,93430,88611,3673,185714,327544,-0.02458199410928068,-0.026472058492317666,Rep (McCain),Rep (Romney),10
minnesota,pipestone,2652,2021,0,4673,2828,1728,81,4637,9570,-0.13503102931735503,-0.2414398595258999,Rep (McCain),Rep (Romney),3
minnesota,dodge,5468,4463,0,9931,5522,4487,263,10272,19829,-0.10119826804954184,-0.10340693375961635,Rep (McCain),Rep (Romney),5
minnesota,benton,10338,8452,0,18790,10849,8173,499,19521,38148,-0.10037253858435338,-0.14067921354221427,Rep (McCain),Rep (Romney),7
minnesota,wright,37779,26343,0,64122,41460,26584,1506,69550,120764,-0.1783475250304108,-0.21862324378343426,Rep (McCain),Rep (Romney),9
minnesota,winona,10970,16307,0,27277,11480,14980,643,27103,51304,0.19565934670234997,0.13227513227513227,Dem (Obama),Dem (Obama),7
minnesota,hubbard,6559,4872,0,11431,6622,4676,184,11482,20205,-0.1475811390079608,-0.17224287484510534,Rep (McCain),Rep (Romney),5
minnesota,cass,8660,7277,0,15937,8957,6858,265,16080,28648,-0.08677919307272385,-0.13272209927284223,Rep (McCain),Rep (Romney),6
minnesota,todd,6637,5277,0,11914,6719,4819,224,11762,24804,-0.11415141849924458,-0.16467325359681054,Rep (McCain),Rep (Romney),5
minnesota,lacquiparle,1913,2160,0,4073,1938,1974,62,3974,7343,0.06064326049594893,0.009202453987730062,Dem (Obama),Dem (Obama),2
minnesota,murray,2320,2345,0,4665,2504,2160,90,4754,8779,0.0053590568060021436,-0.07375643224699828,Dem (Obama),Rep (Romney),2
minnesota,nobles,4368,4244,0,8612,4581,3793,119,8493,21030,-0.014398513701811427,-0.09410078815380941,Rep (McCain),Rep (Romney),5
minnesota,meeker,6737,5380,0,12117,6913,4969,285,12167,23371,-0.11199141701741355,-0.1636088200639623,Rep (McCain),Rep (Romney),5
minnesota,morrison,9734,6547,0,16281,10159,6153,350,16662,33093,-0.19574964682759044,-0.2455860716037273,Rep (McCain),Rep (Romney),6
minnesota,carver,28158,20653,0,48811,31155,20745,847,52747,88668,-0.15375632541845075,-0.20057803468208094,Rep (McCain),Rep (Romney),8
minnesota,ottertail,18077,13856,0,31933,18860,12165,537,31562,57539,-0.13218300817336298,-0.21579371474617245,Rep (McCain),Rep (Romney),8
minnesota,mcleod,10993,7505,0,18498,11069,6970,416,18455,36789,-0.18856092550546005,-0.2272298907921725,Rep (McCain),Rep (Romney),7
minnesota,hennepin,231024,420896,0,651920,240073,423979,13913,677965,1136522,0.29125046017916306,0.27694517899200666,Dem (Obama),Dem (Obama),10
minnesota,bigstone,1362,1552,0,2914,1385,1345,53,2783,5324,0.06520247083047358,-0.014652014652014652,Dem (Obama),Rep (Romney),2
minnesota,aitkin,4591,4601,0,9192,4533,4412,164,9109,16325,0.0010879025239338555,-0.013527110117384014,Dem (Obama),Rep (Romney),4
minnesota,martin,6053,4413,0,10466,6657,4054,216,10927,20865,-0.15669787884578634,-0.2430211931659042,Rep (McCain),Rep (Romney),5
minnesota,freeborn,6955,9915,0,16870,6970,9327,348,16645,31387,0.1754593953764078,0.1446278456157575,Dem (Obama),Dem (Obama),6
minnesota,pine,6862,7084,0,13946,6845,6750,309,13904,29413,0.01591854295138391,-0.006987863184994484,Dem (Obama),Rep (Romney),6
minnesota,becker,8851,7687,0,16538,9204,6829,296,16329,32274,-0.07038335953561495,-0.14813197779579618,Rep (McCain),Rep (Romney),6
minnesota,chippewa,2906,3277,0,6183,2967,3083,126,6176,12426,0.06000323467572376,0.019173553719008266,Dem (Obama),Dem (Obama),3
minnesota,carlton,6549,11501,0,18050,6586,11389,381,18356,34958,0.27434903047091413,0.2672044506258693,Dem (Obama),Dem (Obama),6
minnesota,redlake,983,1119,0,2102,978,928,57,1963,4094,0.06470028544243578,-0.026232948583420776,Dem (Obama),Rep (Romney),1
minnesota,isanti,11325,8248,0,19573,11675,8024,432,20131,37682,-0.15720635569406835,-0.18533935732778314,Rep (McCain),Rep (Romney),7
minnesota,fillmore,4993,5921,0,10914,4913,5713,228,10854,20978,0.08502840388491845,0.07528703180877094,Dem (Obama),Dem (Obama),5
minnesota,brown,7454,5808,0,13262,7938,5630,314,13882,26030,-0.12411400995324989,-0.1701061320754717,Rep (McCain),Rep (Romney),6
minnesota,rock,2773,2078,0,4851,2810,1945,75,4830,9606,-0.1432694289837147,-0.1819137749737119,Rep (McCain),Rep (Romney),3
minnesota,lincoln,1491,1517,0,3008,1594,1428,91,3113,5935,0.008643617021276596,-0.05493050959629384,Dem (Obama),Rep (Romney),2
minnesota,lakeofthewoods,1278,971,0,2249,1306,859,55,2220,4147,-0.1365051133837261,-0.20646651270207853,Rep (McCain),Rep (Romney),1
minnesota,waseca,5212,4401,0,9613,5116,4370,220,9706,19168,-0.08436492250078019,-0.07864220957200084,Rep (McCain),Rep (Romney),5
minnesota,traverse,933,1041,0,1974,860,942,38,1840,3657,0.0547112462006079,0.04550499445061043,Dem (Obama),Dem (Obama),1
minnesota,mower,7075,11604,0,18679,6938,11129,404,18471,38855,0.24246480004282883,0.23196988985443073,Dem (Obama),Dem (Obama),7
minnesota,lake,2636,4174,0,6810,2610,4043,144,6797,10900,0.22584434654919236,0.21539155268300014,Dem (Obama),Dem (Obama),3
mississippi,webster,4032,1321,0,5353,3684,1087,49,4820,10139,-0.5064449841210537,-0.5443303290714735,Rep (McCain),Rep (Romney),3
mississippi,scott,6205,4709,0,10914,5728,4774,82,10584,28180,-0.13707165109034267,-0.09083984003047038,Rep (McCain),Rep (Romney),6
mississippi,jeffersondavis,2512,3924,0,6436,2439,4094,85,6618,12666,0.21939092604101926,0.2533292514924231,Dem (Obama),Dem (Obama),3
mississippi,wilkinson,1556,3498,0,5054,1275,2940,23,4238,10070,0.3842500989315394,0.39501779359430605,Dem (Obama),Dem (Obama),3
mississippi,choctaw,2624,1459,0,4083,2533,1283,31,3847,8680,-0.28532941464609357,-0.3275681341719078,Rep (McCain),Rep (Romney),2
mississippi,prentiss,7703,3020,0,10723,7075,2817,141,10033,25411,-0.4367247971649725,-0.43044884755357865,Rep (McCain),Rep (Romney),5
mississippi,hancock,11614,3195,0,14809,12859,3879,285,17023,42408,-0.5685056384630968,-0.5365037638905484,Rep (McCain),Rep (Romney),7
mississippi,yazoo,4219,5725,0,9944,4560,6220,73,10853,28402,0.1514481094127112,0.15398886827458255,Dem (Obama),Dem (Obama),6
mississippi,pearlriver,16156,3727,0,19883,15836,3813,289,19938,55923,-0.6251068752200373,-0.6118886457326073,Rep (McCain),Rep (Romney),8
mississippi,lee,22403,11769,0,34172,22004,12043,316,34363,81446,-0.3111904483202622,-0.29256615854553997,Rep (McCain),Rep (Romney),8
mississippi,desoto,43510,19265,0,62775,42399,20979,648,64026,154715,-0.3862206292313819,-0.3379721669980119,Rep (McCain),Rep (Romney),9
mississippi,jones,18726,8089,0,26815,20635,9146,257,30038,67144,-0.3966809621480515,-0.38578288170309927,Rep (McCain),Rep (Romney),8
mississippi,marion,7350,3764,0,11114,7118,3833,90,11041,26758,-0.322656109411553,-0.29997260524153047,Rep (McCain),Rep (Romney),6
mississippi,lowndes,13934,13110,0,27044,12399,12037,238,24674,59482,-0.030468865552433073,-0.014814208544770011,Rep (McCain),Rep (Romney),8
mississippi,grenada,6215,4995,0,11210,5980,5279,61,11320,22169,-0.10883140053523639,-0.06226130206945555,Rep (McCain),Rep (Romney),5
mississippi,greene,4358,1362,0,5720,4528,1325,66,5919,14009,-0.5237762237762238,-0.5472407312489321,Rep (McCain),Rep (Romney),4
mississippi,chickasaw,3934,4053,0,7987,3601,3914,126,7641,17689,0.014899211218229623,0.04165003326679973,Dem (Obama),Dem (Obama),4
mississippi,coahoma,2502,6947,0,9449,2356,7164,43,9563,26681,0.470420150280453,0.5050420168067227,Dem (Obama),Dem (Obama),6
mississippi,pike,7441,7958,0,15399,7986,9304,139,17429,40284,0.033573608675888045,0.07622903412377097,Dem (Obama),Dem (Obama),7
mississippi,george,7050,1398,0,8448,8353,1352,121,9826,22061,-0.6690340909090909,-0.7213807315816589,Rep (McCain),Rep (Romney),5
mississippi,sunflower,2900,7158,0,10058,2907,7989,99,10995,30504,0.42334460131238816,0.46640969162995594,Dem (Obama),Dem (Obama),6
mississippi,quitman,1334,2797,0,4131,1116,2837,26,3979,8551,0.3541515371580731,0.435365545155578,Dem (Obama),Dem (Obama),2
mississippi,noxubee,1507,4970,0,6477,1325,4920,19,6264,11747,0.5346611085379034,0.5756605284227382,Dem (Obama),Dem (Obama),3
mississippi,tate,7639,4951,0,12590,6666,4572,136,11374,28198,-0.21350277998411438,-0.18633208756006406,Rep (McCain),Rep (Romney),6
mississippi,calhoun,4068,2242,0,6310,3961,2250,62,6273,14945,-0.2893819334389857,-0.27547898889067785,Rep (McCain),Rep (Romney),4
mississippi,tallahatchie,2435,3646,0,6081,2480,3838,45,6363,15270,0.19914487748725537,0.21494143716365938,Dem (Obama),Dem (Obama),4
mississippi,hinds,29187,68794,0,97981,26450,70512,677,97639,246067,0.4042314326246925,0.45442544501969845,Dem (Obama),Dem (Obama),10
mississippi,covington,5503,3826,0,9329,5282,3800,63,9145,19557,-0.17976203237217278,-0.16317991631799164,Rep (McCain),Rep (Romney),5
mississippi,marshall,6650,9573,0,16223,6444,9581,116,16141,37002,0.18017629291746287,0.19575663026521062,Dem (Obama),Dem (Obama),7
mississippi,clay,4412,6424,0,10836,3735,5860,64,9659,20883,0.18567737172388335,0.22146951537258988,Dem (Obama),Dem (Obama),5
mississippi,carroll,3886,2027,0,5913,3953,1990,25,5968,10608,-0.3143920175883646,-0.3303045599865388,Rep (McCain),Rep (Romney),3
mississippi,copiah,6683,7640,0,14323,5714,7201,87,13002,29521,0.06681561125462543,0.1151374370886566,Dem (Obama),Dem (Obama),6
mississippi,adams,5300,7630,0,12930,5542,7999,80,13621,32659,0.18020108275328692,0.1814489328705413,Dem (Obama),Dem (Obama),6
mississippi,simpson,6660,4393,0,11053,7424,4723,102,12249,27575,-0.2051026870532887,-0.2223594303120112,Rep (McCain),Rep (Romney),6
mississippi,humphreys,1243,3180,0,4423,1069,3399,13,4481,9610,0.4379380510965408,0.5214861235452104,Dem (Obama),Dem (Obama),3
mississippi,sharkey,784,1722,0,2506,675,1571,12,2258,4797,0.3743016759776536,0.39893143365983974,Dem (Obama),Dem (Obama),1
mississippi,jackson,32959,15534,0,48493,33262,15452,576,49290,137082,-0.3593302126080053,-0.3656033173215092,Rep (McCain),Rep (Romney),9
mississippi,claiborne,632,3561,0,4193,608,4633,17,5258,9928,0.6985451943715717,0.7679832093112001,Dem (Obama),Dem (Obama),3
mississippi,attala,5209,3739,0,8948,4452,3368,33,7853,19545,-0.16428252123379525,-0.13861892583120206,Rep (McCain),Rep (Romney),5
mississippi,winston,5473,4606,0,10079,5147,4557,54,9758,19378,-0.08602043853556901,-0.06079967023907667,Rep (McCain),Rep (Romney),5
mississippi,washington,6274,12884,0,19158,4870,12188,79,17137,52455,0.34502557678254514,0.4290069175753312,Dem (Obama),Dem (Obama),8
mississippi,stone,4661,1746,0,6407,4924,1794,102,6820,16923,-0.4549711253316685,-0.46591247395058055,Rep (McCain),Rep (Romney),4
mississippi,panola,7515,8370,0,15885,7629,9079,118,16826,34782,0.053824362606232294,0.08678477376107253,Dem (Obama),Dem (Obama),6
mississippi,monroe,10165,7137,0,17302,9661,6990,138,16789,37282,-0.1750086695179748,-0.16041078613897064,Rep (McCain),Rep (Romney),7
mississippi,oktibbeha,7190,7328,0,14518,7728,8030,243,16001,46529,0.009505441520870643,0.01916486863815205,Dem (Obama),Dem (Obama),7
mississippi,tunica,864,2917,0,3781,867,3371,24,4262,10817,0.542978048135414,0.5908447380840018,Dem (Obama),Dem (Obama),3
mississippi,jefferson,450,3295,0,3745,431,3508,14,3953,7970,0.7596795727636849,0.7811627316577812,Dem (Obama),Dem (Obama),2
mississippi,benton,2329,2224,0,4553,2030,2026,24,4080,8652,-0.023061717548868876,-9.861932938856016e-4,Rep (McCain),Rep (Romney),2
mississippi,lafayette,10278,7997,0,18275,9772,7098,321,17191,45859,-0.12481532147742819,-0.15850622406639003,Rep (McCain),Rep (Romney),7
mississippi,itawamba,7240,1938,0,9178,6925,1599,205,8729,23329,-0.5776857703203312,-0.6248240262787423,Rep (McCain),Rep (Romney),5
mississippi,issaquena,322,523,0,845,302,479,6,787,1893,0.2378698224852071,0.2266325224071703,Dem (Obama),Dem (Obama),1
mississippi,amite,4214,3320,0,7534,4393,3218,50,7661,13318,-0.1186620653039554,-0.15438181579293128,Rep (McCain),Rep (Romney),3
mississippi,jasper,3660,4476,0,8136,4193,5097,50,9340,17383,0.10029498525073746,0.09730893433799785,Dem (Obama),Dem (Obama),4
mississippi,warren,9953,9502,0,19455,9390,9899,140,19429,48890,-0.023181701362117706,0.026388096842760122,Rep (McCain),Dem (Obama),7
mississippi,walthall,4244,3421,0,7665,4012,3386,78,7476,15530,-0.10737116764514025,-0.08461746417950798,Rep (McCain),Rep (Romney),4
mississippi,lauderdale,19368,13048,0,32416,17322,12642,249,30213,79405,-0.1949654491609082,-0.15618742490989188,Rep (McCain),Rep (Romney),8
mississippi,bolivar,4487,9471,0,13958,4346,9772,140,14258,35063,0.35707121364092276,0.38433205836520756,Dem (Obama),Dem (Obama),6
mississippi,clarke,4679,2727,0,7406,4415,2695,89,7199,16808,-0.26357007831487983,-0.2419127988748242,Rep (McCain),Rep (Romney),4
mississippi,leflore,3444,7947,0,11391,3115,8423,62,11600,33109,0.39531208849091387,0.46004506846940546,Dem (Obama),Dem (Obama),6
mississippi,forrest,15296,11622,0,26918,15339,12079,371,27789,74290,-0.13648859499219854,-0.11889999270552191,Rep (McCain),Rep (Romney),8
mississippi,wayne,6056,3860,0,9916,6080,4116,73,10269,20971,-0.22146026623638565,-0.19262455865045117,Rep (McCain),Rep (Romney),5
mississippi,tippah,6809,2514,0,9323,6625,2254,129,9008,21993,-0.46068861954306556,-0.492285167248564,Rep (McCain),Rep (Romney),5
mississippi,kemper,1694,2876,0,4570,1789,3239,24,5052,10470,0.25864332603938733,0.28838504375497215,Dem (Obama),Dem (Obama),3
mississippi,smith,5715,1821,0,7536,6049,1979,71,8099,16443,-0.51671974522293,-0.5069755854509218,Rep (McCain),Rep (Romney),4
mississippi,madison,24781,18034,0,42815,28507,20722,342,49571,91987,-0.15758495854256685,-0.1581384956021857,Rep (McCain),Rep (Romney),9
mississippi,pontotoc,9656,2951,0,12607,9403,2785,160,12348,29523,-0.5318473863726502,-0.5429931079750574,Rep (McCain),Rep (Romney),6
mississippi,neshoba,7205,2584,0,9789,7772,3030,88,10890,29545,-0.47206047604453977,-0.4389927791149787,Rep (McCain),Rep (Romney),6
mississippi,tishomingo,6195,1941,0,8136,6070,1623,157,7850,19535,-0.5228613569321534,-0.5780579747822696,Rep (McCain),Rep (Romney),5
mississippi,montgomery,2638,2244,0,4882,2543,2245,19,4807,11138,-0.08070462925030725,-0.06223893065998329,Rep (McCain),Rep (Romney),3
mississippi,franklin,2896,1722,0,4618,2705,1706,32,4443,8130,-0.25422260718925943,-0.22647925640444344,Rep (McCain),Rep (Romney),2
mississippi,yalobusha,3604,3104,0,6708,3261,2984,48,6293,12869,-0.07453786523553965,-0.04435548438751001,Rep (McCain),Rep (Romney),3
mississippi,perry,4040,1521,0,5561,4110,1519,57,5686,12243,-0.45297608343823054,-0.4602949014034464,Rep (McCain),Rep (Romney),3
mississippi,holmes,1504,6945,0,8449,1264,6775,37,8076,19597,0.6439815362764825,0.6855330264958328,Dem (Obama),Dem (Obama),5
mississippi,harrison,37927,22175,0,60102,38646,22242,714,61602,181791,-0.2620877841003627,-0.2694126921560899,Rep (McCain),Rep (Romney),9
mississippi,union,8302,2727,0,11029,7759,2481,119,10359,26922,-0.5054855381267568,-0.5154296875,Rep (McCain),Rep (Romney),6
mississippi,lincoln,10781,5505,0,16286,9333,4879,91,14303,34622,-0.3239592287854599,-0.3133971291866029,Rep (McCain),Rep (Romney),6
mississippi,leake,4509,3575,0,8084,4283,3599,39,7921,23547,-0.11553686293913903,-0.0867800050748541,Rep (McCain),Rep (Romney),5
mississippi,rankin,47645,14235,0,61880,46318,14425,695,61438,138523,-0.5399159663865546,-0.5250481536967223,Rep (McCain),Rep (Romney),9
mississippi,newton,6338,3063,0,9401,5909,3069,61,9039,21828,-0.3483671949792575,-0.3163288037424816,Rep (McCain),Rep (Romney),5
mississippi,lawrence,4318,2513,0,6831,4153,2394,37,6584,13016,-0.26423656858439465,-0.26867267450740795,Rep (McCain),Rep (Romney),3
mississippi,lamar,16969,4694,0,21663,17472,5037,271,22780,52559,-0.5666343535059779,-0.5524456883913101,Rep (McCain),Rep (Romney),8
mississippi,alcorn,9752,3701,0,13453,11027,3449,206,14682,36708,-0.4497881513417082,-0.5234871511467256,Rep (McCain),Rep (Romney),7
missouri,bates,4833,3271,0,8104,5020,2557,194,7771,17132,-0.19274432379072062,-0.3250626897188861,Rep (McCain),Rep (Romney),4
missouri,dunklin,7034,4528,0,11562,6849,3635,165,10649,32140,-0.21674450787061061,-0.3065623807706982,Rep (McCain),Rep (Romney),6
missouri,osage,5061,1905,0,6966,5330,1472,116,6918,13768,-0.45305770887166236,-0.5671861217289033,Rep (McCain),Rep (Romney),3
missouri,stoddard,9172,3899,0,13071,9496,3153,217,12866,30089,-0.4034121337311606,-0.5014625662107677,Rep (McCain),Rep (Romney),6
missouri,ozark,2917,1661,0,4578,3080,1261,112,4453,9688,-0.2743556138051551,-0.41902787376180606,Rep (McCain),Rep (Romney),3
missouri,butler,11804,5316,0,17120,12248,4363,278,16889,42437,-0.3789719626168224,-0.4746854494009993,Rep (McCain),Rep (Romney),7
missouri,lewis,2596,1836,0,4432,2677,1507,94,4278,10235,-0.17148014440433212,-0.27963671128107076,Rep (McCain),Rep (Romney),3
missouri,gentry,1964,1235,0,3199,1986,937,74,2997,6760,-0.2278837136605189,-0.3588778652069791,Rep (McCain),Rep (Romney),2
missouri,howard,2689,2020,0,4709,3012,1722,127,4861,10120,-0.14206837969844976,-0.27249683143219267,Rep (McCain),Rep (Romney),3
missouri,ralls,2987,2041,0,5028,3231,1736,69,5036,10127,-0.18814638027048528,-0.30098651097241796,Rep (McCain),Rep (Romney),3
missouri,randolph,6445,3978,0,10423,6667,3031,246,9944,25495,-0.23668809363906745,-0.37492266446690037,Rep (McCain),Rep (Romney),5
missouri,grundy,3006,1580,0,4586,3030,1212,132,4374,10214,-0.31094635848233754,-0.42857142857142855,Rep (McCain),Rep (Romney),3
missouri,audrain,6166,4433,0,10599,6186,3538,227,9951,25684,-0.1635059911312388,-0.2723159193747429,Rep (McCain),Rep (Romney),5
missouri,jackson,124178,209946,0,334124,121891,180100,4863,306854,666997,0.2566951191773114,0.1927507773410466,Dem (Obama),Dem (Obama),10
missouri,monroe,2532,1703,0,4235,2564,1398,95,4057,9078,-0.19574970484061394,-0.2942958101968703,Rep (McCain),Rep (Romney),2
missouri,shannon,2075,1637,0,3712,2260,1300,128,3688,8404,-0.11799568965517242,-0.2696629213483146,Rep (McCain),Rep (Romney),2
missouri,morgan,5451,3565,0,9016,5733,2773,182,8688,20631,-0.20918367346938777,-0.3479896543616271,Rep (McCain),Rep (Romney),5
missouri,putnam,1591,695,0,2286,1673,587,49,2309,5040,-0.39195100612423445,-0.48053097345132745,Rep (McCain),Rep (Romney),1
missouri,pettis,11012,6927,0,17939,10840,5902,429,17171,41587,-0.22771614917219465,-0.2949468402819257,Rep (McCain),Rep (Romney),7
missouri,madison,2897,2042,0,4939,3227,1588,115,4930,12269,-0.1731119659850172,-0.3403946002076843,Rep (McCain),Rep (Romney),3
missouri,knox,1211,758,0,1969,1205,698,54,1957,4134,-0.23006602336211274,-0.26642143983184446,Rep (McCain),Rep (Romney),1
missouri,harrison,2512,1287,0,3799,2624,984,87,3695,8941,-0.32245327717820477,-0.45454545454545453,Rep (McCain),Rep (Romney),2
missouri,livingston,3993,2435,0,6428,4006,1906,142,6054,14961,-0.24237710018668326,-0.35520974289580515,Rep (McCain),Rep (Romney),4
missouri,webster,10427,5683,0,16110,10702,4407,312,15421,35678,-0.29447548106765986,-0.4166390892845324,Rep (McCain),Rep (Romney),6
missouri,stegenevieve,3732,4979,0,8711,4055,3813,202,8070,18205,0.1431523361267363,-0.030757498729028977,Dem (Obama),Rep (Romney),4
missouri,pemiscot,3954,3029,0,6983,3596,2671,66,6333,18587,-0.13246455678075325,-0.1475985319929791,Rep (McCain),Rep (Romney),4
missouri,douglas,4405,2140,0,6545,4649,1709,198,6556,13689,-0.3460656990068755,-0.46240956275558354,Rep (McCain),Rep (Romney),3
missouri,shelby,2166,1114,0,3280,2188,966,78,3232,6439,-0.3207317073170732,-0.3874445149017121,Rep (McCain),Rep (Romney),2
missouri,vernon,5333,3379,0,8712,5756,2580,183,8519,20917,-0.22428833792470157,-0.3809980806142035,Rep (McCain),Rep (Romney),5
missouri,buchanan,19110,19157,0,38267,18660,15594,852,35106,88195,0.001228212297802284,-0.08950779471010685,Dem (Obama),Rep (Romney),8
missouri,iron,2090,2213,0,4303,2252,1669,110,4031,10670,0.0285847083430165,-0.1486865595511349,Dem (Obama),Rep (Romney),3
missouri,howell,10974,5732,0,16706,11541,4393,407,16341,39763,-0.3137794804261942,-0.4486004769674909,Rep (McCain),Rep (Romney),7
missouri,pike,4262,3481,0,7743,4576,2581,162,7319,18590,-0.10086529768823453,-0.2787480788039681,Rep (McCain),Rep (Romney),4
missouri,holt,1791,802,0,2593,1725,551,34,2310,4944,-0.3814114924797532,-0.515817223198594,Rep (McCain),Rep (Romney),1
missouri,macon,4586,2784,0,7370,4700,2309,150,7159,15539,-0.2445047489823609,-0.34113282921957483,Rep (McCain),Rep (Romney),4
missouri,moniteau,4467,2084,0,6551,4703,1608,131,6442,15468,-0.3637612578232331,-0.4904135636190778,Rep (McCain),Rep (Romney),4
missouri,stfrancois,12659,11538,0,24197,13248,8837,505,22590,64239,-0.0463280571971732,-0.19972832239076296,Rep (McCain),Rep (Romney),8
missouri,clay,54425,53651,0,108076,56131,47250,2084,105465,215015,-0.007161627003219957,-0.08590553389887891,Rep (McCain),Rep (Romney),10
missouri,bollinger,3971,1690,0,5661,4094,1213,148,5455,12445,-0.4029323441088147,-0.5428679103071415,Rep (McCain),Rep (Romney),3
missouri,stlouiscity,24562,132260,0,156822,22617,116654,1864,141135,318809,0.6867531341265893,0.6752087656439604,Dem (Obama),Dem (Obama),10
missouri,phelps,11704,7393,0,19097,11893,5798,497,18188,44473,-0.22574226318269885,-0.34452546492566843,Rep (McCain),Rep (Romney),7
missouri,benton,5757,3628,0,9385,6069,2925,163,9157,18975,-0.22685135855087907,-0.3495663775850567,Rep (McCain),Rep (Romney),4
missouri,cass,29691,19840,0,49531,30912,17044,957,48913,97598,-0.1988855464254709,-0.28918174993744267,Rep (McCain),Rep (Romney),9
missouri,warren,8673,6705,0,15378,9150,5219,307,14676,31635,-0.12797502926258292,-0.273575057415269,Rep (McCain),Rep (Romney),6
missouri,sullivan,1607,1173,0,2780,1610,908,77,2595,6728,-0.15611510791366906,-0.27879269261318507,Rep (McCain),Rep (Romney),2
missouri,perry,5527,3005,0,8532,5669,2184,134,7987,18919,-0.29559306141584624,-0.4437794473449637,Rep (McCain),Rep (Romney),4
missouri,barry,9758,4630,0,14388,9832,3667,307,13806,35753,-0.3564081178760078,-0.4567004963330617,Rep (McCain),Rep (Romney),6
missouri,clark,1782,1572,0,3354,1730,1398,97,3225,7169,-0.0626118067978533,-0.10613810741687979,Rep (McCain),Rep (Romney),2
missouri,scott,11563,6258,0,17821,11623,5122,254,16999,39370,-0.29768250939902363,-0.38823529411764707,Rep (McCain),Rep (Romney),7
missouri,capegirardeau,24767,12208,0,36975,25343,9713,616,35672,74283,-0.3396619337390128,-0.44585805568233683,Rep (McCain),Rep (Romney),8
missouri,maries,2851,1598,0,4449,3165,1299,74,4538,9203,-0.2816363227691616,-0.41801075268817206,Rep (McCain),Rep (Romney),2
missouri,crawford,6007,3911,0,9918,6434,2951,194,9579,24640,-0.21133293002621495,-0.37112413425679275,Rep (McCain),Rep (Romney),5
missouri,cedar,4193,2060,0,6253,4375,1536,132,6043,14091,-0.34111626419318725,-0.48029098291321265,Rep (McCain),Rep (Romney),4
missouri,nodaway,5568,4493,0,10061,5593,3172,211,8976,23031,-0.10684822582248285,-0.2762122076440388,Rep (McCain),Rep (Romney),5
missouri,scotland,1249,793,0,2042,1246,643,47,1936,4831,-0.22331047992164543,-0.31921651667548967,Rep (McCain),Rep (Romney),1
missouri,texas,7213,3410,0,10623,7618,2871,275,10764,25662,-0.35799679939753365,-0.45256935837544093,Rep (McCain),Rep (Romney),5
missouri,dekalb,2889,1692,0,4581,3056,1194,100,4350,12872,-0.26129666011787817,-0.43811764705882356,Rep (McCain),Rep (Romney),3
missouri,henry,6092,4869,0,10961,6229,3604,288,10121,22373,-0.11157741082018063,-0.26695820197294823,Rep (McCain),Rep (Romney),5
missouri,stone,11137,5025,0,16162,11780,3920,274,15974,32003,-0.3781710184383121,-0.5006369426751592,Rep (McCain),Rep (Romney),6
missouri,clinton,5709,4543,0,10252,5904,3685,241,9830,20682,-0.11373390557939914,-0.23141099176139326,Rep (McCain),Rep (Romney),5
missouri,miller,7797,3553,0,11350,8099,2651,269,11019,24805,-0.37392070484581497,-0.5067906976744186,Rep (McCain),Rep (Romney),5
missouri,chariton,2338,1799,0,4137,2402,1339,80,3821,7871,-0.13028764805414553,-0.2841486233627372,Rep (McCain),Rep (Romney),2
missouri,jefferson,50793,53457,0,104250,53973,41570,2070,97613,216262,0.025553956834532373,-0.12981589441403346,Dem (Obama),Rep (Romney),10
missouri,mercer,1169,519,0,1688,1255,353,47,1655,3731,-0.38507109004739337,-0.5609452736318408,Rep (McCain),Rep (Romney),1
missouri,wright,5780,2556,0,8336,5831,1953,172,7956,18731,-0.3867562380038388,-0.4982014388489209,Rep (McCain),Rep (Romney),4
missouri,andrew,5279,3345,0,8624,5457,2649,200,8306,17006,-0.2242578849721707,-0.3464100666173205,Rep (McCain),Rep (Romney),4
missouri,lafayette,9433,6891,0,16324,9800,5650,336,15786,33313,-0.15572163685371232,-0.2686084142394822,Rep (McCain),Rep (Romney),6
missouri,newmadrid,4593,3370,0,7963,4284,2814,152,7250,18847,-0.15358533216124576,-0.20710059171597633,Rep (McCain),Rep (Romney),4
missouri,oregon,2652,1811,0,4463,2886,1419,116,4421,10739,-0.18843827022182388,-0.3407665505226481,Rep (McCain),Rep (Romney),3
missouri,pulaski,9551,5251,0,14802,9092,4199,280,13571,49114,-0.2905012836103229,-0.3681438567451659,Rep (McCain),Rep (Romney),7
missouri,platte,24458,21454,0,45912,25617,19171,759,45547,86894,-0.06542951733751524,-0.14392247923550952,Rep (McCain),Rep (Romney),8
missouri,ripley,3406,1795,0,5201,3743,1396,124,5263,14057,-0.3097481253605076,-0.4567036388402413,Rep (McCain),Rep (Romney),4
missouri,linn,3139,2635,0,5774,3331,2031,165,5527,12824,-0.08728784205057152,-0.2424468481909735,Rep (McCain),Rep (Romney),3
missouri,caldwell,2652,1812,0,4464,2724,1313,134,4171,9380,-0.1881720430107527,-0.3495169680455784,Rep (McCain),Rep (Romney),3
missouri,wayne,3784,2242,0,6026,3790,1811,117,5718,13433,-0.2558911384002655,-0.35332976254240317,Rep (McCain),Rep (Romney),3
missouri,cooper,4902,2996,0,7898,4887,2474,150,7511,17583,-0.24132691820714106,-0.3278087216410814,Rep (McCain),Rep (Romney),4
missouri,franklin,27351,21251,0,48602,29271,16294,1008,46573,100737,-0.1255092383029505,-0.28480193130692416,Rep (McCain),Rep (Romney),9
missouri,montgomery,3426,2346,0,5772,3486,1734,97,5317,12247,-0.18711018711018712,-0.335632183908046,Rep (McCain),Rep (Romney),3
missouri,christian,25376,11876,0,37252,27465,9809,678,37952,74156,-0.36239664984430364,-0.47368138648924185,Rep (McCain),Rep (Romney),8
missouri,lawrence,11260,5097,0,16357,11417,4014,317,15748,38373,-0.3767805832365348,-0.4797485580973365,Rep (McCain),Rep (Romney),7
missouri,newton,17637,7450,0,25087,18179,6425,476,25080,57561,-0.4060668872324311,-0.47772719882945863,Rep (McCain),Rep (Romney),8
missouri,dade,2864,1184,0,4048,2895,939,62,3896,7929,-0.4150197628458498,-0.5101721439749609,Rep (McCain),Rep (Romney),2
missouri,polk,8956,4553,0,13509,9252,3580,287,13119,30729,-0.32593086090754314,-0.44201995012468825,Rep (McCain),Rep (Romney),6
missouri,boone,36803,46960,0,83763,37343,39782,2171,79296,158067,0.12125878968040782,0.031623987034035655,Dem (Obama),Dem (Obama),9
missouri,carter,1838,986,0,2824,1978,754,67,2799,6141,-0.301699716713881,-0.4480234260614934,Rep (McCain),Rep (Romney),2
missouri,schuyler,1139,775,0,1914,1174,697,68,1939,4361,-0.19017763845350052,-0.25494388027792625,Rep (McCain),Rep (Romney),1
missouri,callaway,11388,7578,0,18966,11742,6070,416,18228,43769,-0.20088579563429296,-0.31843700875814057,Rep (McCain),Rep (Romney),7
missouri,mcdonald,5499,2454,0,7953,5694,1920,203,7817,23016,-0.38287438702376464,-0.49566587864460204,Rep (McCain),Rep (Romney),5
missouri,worth,707,427,0,1134,664,341,43,1048,2188,-0.24691358024691357,-0.32139303482587067,Rep (McCain),Rep (Romney),1
missouri,greene,77393,55928,0,133321,76786,46130,2723,125639,270190,-0.16100239272132671,-0.24940609847375445,Rep (McCain),Rep (Romney),10
missouri,marion,7702,4701,0,12403,7926,4034,204,12164,28579,-0.2419575909054261,-0.3254180602006689,Rep (McCain),Rep (Romney),6
missouri,taney,14714,6676,0,21390,15713,5462,433,21608,49324,-0.37578307620383355,-0.4841086186540732,Rep (McCain),Rep (Romney),7
missouri,atchison,1936,1000,0,2936,1902,756,51,2709,5811,-0.3188010899182561,-0.43115124153498874,Rep (McCain),Rep (Romney),2
missouri,daviess,2263,1400,0,3663,2282,1124,106,3512,8359,-0.2355992355992356,-0.33998825601879035,Rep (McCain),Rep (Romney),2
missouri,mississippi,3034,2247,0,5281,2996,1857,65,4918,14143,-0.14902480590797199,-0.23470018545229754,Rep (McCain),Rep (Romney),4
missouri,barton,4415,1455,0,5870,4416,1232,98,5746,12634,-0.504258943781942,-0.5637393767705382,Rep (McCain),Rep (Romney),3
missouri,stlouis,219787,330157,0,549944,223102,294735,6791,524628,999454,0.20069316148553307,0.1383311737091015,Dem (Obama),Dem (Obama),10
missouri,hickory,2850,2171,0,5021,2835,1733,112,4680,9579,-0.1352320254929297,-0.24124343257443082,Rep (McCain),Rep (Romney),3
missouri,dallas,4895,2656,0,7551,4992,2122,165,7279,16813,-0.29651701761356114,-0.4034298566207478,Rep (McCain),Rep (Romney),4
missouri,camden,14074,7772,0,21846,15089,6458,395,21942,43157,-0.28847386249198936,-0.4005662041119413,Rep (McCain),Rep (Romney),7
missouri,carroll,2955,1535,0,4490,3072,1154,78,4304,9485,-0.31625835189309576,-0.4538570752484619,Rep (McCain),Rep (Romney),3
missouri,gasconade,4763,2899,0,7662,4895,2099,140,7134,15334,-0.24327851735839207,-0.39977123248498714,Rep (McCain),Rep (Romney),4
missouri,washington,4703,4712,0,9415,5008,3402,206,8616,24981,9.559214020180563e-4,-0.19096313912009513,Dem (Obama),Rep (Romney),5
missouri,ray,5593,5241,0,10834,5805,4264,277,10346,23667,-0.032490308288720696,-0.1530439964246698,Rep (McCain),Rep (Romney),5
missouri,saline,4957,4705,0,9662,5096,3785,214,9095,23126,-0.02608155661353757,-0.14761851142889315,Rep (McCain),Rep (Romney),5
missouri,jasper,31634,15718,0,47352,31345,12808,1060,45213,115029,-0.336120966379456,-0.4198355717618282,Rep (McCain),Rep (Romney),9
missouri,stcharles,102538,84163,0,186701,110732,71798,3067,185597,350606,-0.09841939786075062,-0.2133019229715663,Rep (McCain),Rep (Romney),10
missouri,reynolds,1779,1415,0,3194,1927,1155,114,3196,6698,-0.11396368190356919,-0.25048669695003245,Rep (McCain),Rep (Romney),2
missouri,johnson,12178,9474,0,21652,12750,7661,590,21001,52041,-0.1248845372251986,-0.24932634363823428,Rep (McCain),Rep (Romney),7
missouri,stclair,2981,1886,0,4867,3019,1460,147,4626,9757,-0.22498459009656874,-0.34806876534940834,Rep (McCain),Rep (Romney),3
missouri,dent,4655,2056,0,6711,4883,1585,175,6643,15497,-0.38727462375204885,-0.5098948670377241,Rep (McCain),Rep (Romney),4
missouri,cole,24383,13952,0,38335,24488,12003,567,37058,74767,-0.2721012129907395,-0.34213915760050423,Rep (McCain),Rep (Romney),8
missouri,laclede,10872,5217,0,16089,10934,4093,334,15361,35357,-0.35148237926533654,-0.45524722166766485,Rep (McCain),Rep (Romney),6
missouri,adair,5891,5735,0,11626,5648,4218,255,10121,25315,-0.013418200584895923,-0.14494222582606933,Rep (McCain),Rep (Romney),5
missouri,lincoln,12921,10231,0,23152,14330,7733,586,22649,51333,-0.11618866620594333,-0.29900738793455106,Rep (McCain),Rep (Romney),7
montana,wheatland,632,286,0,918,690,272,27,989,2118,-0.3769063180827887,-0.43451143451143454,Rep (McCain),Rep (Romney),1
montana,toole,1321,736,0,2057,1440,582,80,2102,5143,-0.28439474963539135,-0.42433234421364985,Rep (McCain),Rep (Romney),1
montana,ravalli,12922,8332,0,21254,12817,6466,514,19797,40013,-0.21595934882845583,-0.32935746512472125,Rep (McCain),Rep (Romney),7
montana,powderriver,797,207,0,1004,833,170,16,1019,1659,-0.5876494023904383,-0.6610169491525424,Rep (McCain),Rep (Romney),1
montana,carbon,3093,2431,0,5524,3513,2126,167,5806,9994,-0.11984069514844316,-0.2459655967370101,Rep (McCain),Rep (Romney),3
montana,broadwater,1497,604,0,2101,2150,761,94,3005,5287,-0.4250356972870062,-0.4771556166265888,Rep (McCain),Rep (Romney),2
montana,stillwater,2984,1510,0,4494,3237,1209,114,4560,8934,-0.3279928793947485,-0.45614035087719296,Rep (McCain),Rep (Romney),2
montana,carter,573,111,0,684,678,96,20,794,1289,-0.6754385964912281,-0.751937984496124,Rep (McCain),Rep (Romney),1
montana,prairie,503,211,0,714,518,167,16,701,1089,-0.40896358543417366,-0.5124087591240876,Rep (McCain),Rep (Romney),1
montana,chouteau,1625,1118,0,2743,1751,969,84,2804,5765,-0.1848341232227488,-0.2875,Rep (McCain),Rep (Romney),2
montana,treasure,310,154,0,464,317,114,22,453,848,-0.33620689655172414,-0.4709976798143852,Rep (McCain),Rep (Romney),1
montana,silverbow,4806,11651,0,16457,5374,10782,461,16617,33797,0.41593242996901014,0.33473632087150285,Dem (Obama),Dem (Obama),6
montana,teton,1873,1291,0,3164,2091,1073,86,3250,6105,-0.18394437420986093,-0.3217446270543616,Rep (McCain),Rep (Romney),2
montana,richland,3158,1196,0,4354,3479,992,131,4602,9498,-0.4506201194304088,-0.5562513978975621,Rep (McCain),Rep (Romney),3
montana,pondera,1583,1224,0,2807,1666,969,69,2704,6145,-0.1278945493409334,-0.2645161290322581,Rep (McCain),Rep (Romney),2
montana,sheridan,987,953,0,1940,1203,661,56,1920,3505,-0.01752577319587629,-0.2907725321888412,Rep (McCain),Rep (Romney),1
montana,rosebud,1739,1898,0,3637,2035,1478,97,3610,9134,0.04371734946384383,-0.15855394249928836,Dem (Obama),Rep (Romney),2
montana,yellowstone,36225,31740,0,67965,40421,26275,1865,68561,144050,-0.06598984771573604,-0.21209667746191677,Rep (McCain),Rep (Romney),9
montana,phillips,1423,638,0,2061,1688,471,69,2228,4206,-0.38088306647258613,-0.5636868920796665,Rep (McCain),Rep (Romney),1
montana,judithbasin,799,396,0,1195,852,336,24,1212,1967,-0.3372384937238494,-0.43434343434343436,Rep (McCain),Rep (Romney),1
montana,powell,1679,1021,0,2700,1798,884,81,2763,7077,-0.2437037037037037,-0.3407904548844146,Rep (McCain),Rep (Romney),2
montana,deerlodge,1481,3341,0,4822,1431,2829,148,4408,9270,0.3857320613853173,0.32816901408450705,Dem (Obama),Dem (Obama),2
montana,mineral,1051,844,0,1895,1212,698,99,2009,4193,-0.10923482849604221,-0.26910994764397905,Rep (McCain),Rep (Romney),1
montana,bighorn,1622,3490,0,5112,1655,2830,76,4561,12663,0.365414710485133,0.26198439241917504,Dem (Obama),Dem (Obama),3
montana,gallatin,17433,14912,0,32345,24051,21534,1528,47113,87676,-0.07794094914206215,-0.055215531424810796,Rep (McCain),Rep (Romney),8
montana,hill,2763,3563,0,6326,3133,3372,252,6757,16007,0.12646221941195068,0.03674096848578017,Dem (Obama),Dem (Obama),4
montana,valley,2099,1616,0,3715,2337,1386,137,3860,7345,-0.1300134589502019,-0.25543916196615635,Rep (McCain),Rep (Romney),2
montana,missoula,20266,35701,0,55967,23285,34380,1709,59374,107288,0.27578751764432613,0.1924044047515824,Dem (Obama),Dem (Obama),9
montana,blaine,1138,1711,0,2849,1169,1598,65,2832,6472,0.20112320112320112,0.1550415612576798,Dem (Obama),Dem (Obama),2
montana,daniels,692,343,0,1035,735,236,30,1001,1649,-0.33719806763285026,-0.513903192584964,Rep (McCain),Rep (Romney),1
montana,beaverhead,2983,1611,0,4594,3251,1347,151,4749,9132,-0.29865041358293426,-0.4140930839495433,Rep (McCain),Rep (Romney),2
montana,fergus,4100,1921,0,6021,4243,1628,173,6044,11513,-0.36190001660853677,-0.4454096406063703,Rep (McCain),Rep (Romney),3
montana,cascade,16675,17486,0,34161,18039,14949,964,33952,80562,0.023740522818418666,-0.09367042560931248,Dem (Obama),Rep (Romney),8
montana,mccone,726,321,0,1047,742,221,25,988,1714,-0.3868194842406877,-0.5410176531671859,Rep (McCain),Rep (Romney),1
montana,liberty,594,367,0,961,698,257,28,983,2261,-0.23621227887617066,-0.4617801047120419,Rep (McCain),Rep (Romney),1
montana,jefferson,3525,2574,0,6099,4042,2256,192,6490,11166,-0.1559272011805214,-0.2835820895522388,Rep (McCain),Rep (Romney),3
montana,fallon,1082,318,0,1400,1123,236,40,1399,2813,-0.5457142857142857,-0.6526857983811626,Rep (McCain),Rep (Romney),1
montana,flathead,25361,15976,0,41337,27694,13534,1237,42465,89215,-0.22703631129496576,-0.3434559037547298,Rep (McCain),Rep (Romney),9
montana,granite,1013,601,0,1614,1107,533,65,1705,3044,-0.2552664188351921,-0.35,Rep (McCain),Rep (Romney),1
montana,sanders,3556,1964,0,5520,3971,1716,201,5888,11366,-0.28840579710144926,-0.3965183752417795,Rep (McCain),Rep (Romney),3
montana,garfield,595,109,0,704,622,66,12,700,1224,-0.6903409090909091,-0.8081395348837209,Rep (McCain),Rep (Romney),1
montana,sweetgrass,1433,552,0,1985,1584,473,48,2105,3717,-0.44382871536523927,-0.5401069518716578,Rep (McCain),Rep (Romney),1
montana,dawson,2626,1587,0,4213,3024,1219,174,4417,8933,-0.24661761215286018,-0.4254065519679472,Rep (McCain),Rep (Romney),2
montana,petroleum,227,68,0,295,240,49,9,298,598,-0.5389830508474577,-0.6608996539792388,Rep (McCain),Rep (Romney),1
montana,musselshell,1552,615,0,2167,1792,482,79,2353,4339,-0.43239501615136133,-0.5760773966578716,Rep (McCain),Rep (Romney),1
montana,meagher,624,298,0,922,670,269,33,972,2024,-0.35357917570498915,-0.42705005324813633,Rep (McCain),Rep (Romney),1
montana,madison,2803,1596,0,4399,3115,1285,111,4511,7588,-0.2743805410320527,-0.4159090909090909,Rep (McCain),Rep (Romney),2
montana,lewisandclark,14794,16939,0,31733,16673,15479,880,33032,61643,0.06759524784924212,-0.037136103508335405,Dem (Obama),Rep (Romney),8
montana,goldenvalley,342,122,0,464,351,110,18,479,810,-0.47413793103448276,-0.5227765726681128,Rep (McCain),Rep (Romney),1
montana,roosevelt,1455,2527,0,3982,1503,2044,71,3618,10273,0.2692114515318935,0.15252325909219058,Dem (Obama),Dem (Obama),3
montana,wibaux,379,146,0,525,421,25,98,544,1067,-0.4438095238095238,-0.8878923766816144,Rep (McCain),Rep (Romney),1
montana,park,4349,4140,0,8489,4637,3728,269,8634,15752,-0.024620096595594297,-0.1086670651524208,Rep (McCain),Rep (Romney),4
montana,custer,3040,2262,0,5302,3353,1824,159,5336,11548,-0.14673708034703886,-0.29534479428240296,Rep (McCain),Rep (Romney),3
montana,lincoln,5699,3018,0,8717,6045,2544,280,8869,19507,-0.30755994034644946,-0.40761439049947606,Rep (McCain),Rep (Romney),5
montana,lake,6463,6693,0,13156,7084,5715,357,13156,28493,0.017482517482517484,-0.10696148136573169,Dem (Obama),Rep (Romney),6
montana,glacier,1443,3361,0,4804,1391,2784,112,4287,13251,0.39925062447960036,0.33365269461077846,Dem (Obama),Dem (Obama),3
nebraska,webster,1323,550,0,1873,1255,440,35,1730,3815,-0.41270688734650296,-0.4808259587020649,Rep (McCain),Rep (Romney),1
nebraska,gage,5389,4405,0,9794,5470,3870,212,9552,22591,-0.10046967531141515,-0.17130620985010706,Rep (McCain),Rep (Romney),5
nebraska,mcpherson,240,45,0,285,237,41,12,290,489,-0.6842105263157895,-0.7050359712230215,Rep (McCain),Rep (Romney),1
nebraska,douglas,97425,104026,0,201451,108319,99261,2921,210501,505545,0.03276727343125624,-0.043636188457462186,Dem (Obama),Rep (Romney),10
nebraska,burt,1895,1406,0,3301,2016,1280,47,3343,6964,-0.14813692820357469,-0.22330097087378642,Rep (McCain),Rep (Romney),2
nebraska,seward,4596,2671,0,7267,4947,2362,136,7445,16628,-0.2648961056832255,-0.3536735531536462,Rep (McCain),Rep (Romney),4
nebraska,dundy,783,218,0,1001,791,176,14,981,1963,-0.5644355644355644,-0.6359875904860393,Rep (McCain),Rep (Romney),1
nebraska,garden,844,283,0,1127,829,242,17,1088,2060,-0.49778172138420584,-0.5480859010270775,Rep (McCain),Rep (Romney),1
nebraska,polk,1810,665,0,2475,1886,527,33,2446,5412,-0.4626262626262626,-0.5631993369249897,Rep (McCain),Rep (Romney),2
nebraska,kimball,1328,427,0,1755,1222,391,52,1665,3814,-0.5133903133903134,-0.5151890886546807,Rep (McCain),Rep (Romney),1
nebraska,gosper,771,260,0,1031,732,230,13,975,2058,-0.495635305528613,-0.5218295218295218,Rep (McCain),Rep (Romney),1
nebraska,cedar,2912,1187,0,4099,3231,952,77,4260,8906,-0.42083434984142476,-0.5448242887879512,Rep (McCain),Rep (Romney),2
nebraska,boone,2042,742,0,2784,2136,615,48,2799,5553,-0.46695402298850575,-0.5528898582333697,Rep (McCain),Rep (Romney),2
nebraska,keyapaha,409,115,0,524,392,80,9,481,740,-0.5610687022900763,-0.6610169491525424,Rep (McCain),Rep (Romney),1
nebraska,butler,2534,1175,0,3709,2729,1028,61,3818,8382,-0.3664060393637099,-0.45275485759914824,Rep (McCain),Rep (Romney),2
nebraska,antelope,2367,754,0,3121,2585,571,53,3209,6742,-0.5168215315603973,-0.638149556400507,Rep (McCain),Rep (Romney),2
nebraska,york,4807,1594,0,6401,4814,1352,80,6246,13886,-0.501952819871895,-0.5614661044437237,Rep (McCain),Rep (Romney),4
nebraska,kearney,2217,870,0,3087,2341,761,54,3156,6552,-0.4363459669582119,-0.5093488072211476,Rep (McCain),Rep (Romney),2
nebraska,sheridan,1934,451,0,2385,2010,389,51,2450,5538,-0.6218029350104822,-0.6756982075864943,Rep (McCain),Rep (Romney),2
nebraska,nance,1110,540,0,1650,1098,477,29,1604,3755,-0.34545454545454546,-0.3942857142857143,Rep (McCain),Rep (Romney),1
nebraska,deuel,732,243,0,975,763,215,34,1012,1963,-0.5015384615384615,-0.5603271983640081,Rep (McCain),Rep (Romney),1
nebraska,colfax,2014,1125,0,3139,2045,959,43,3047,10201,-0.2832112137623447,-0.3615179760319574,Rep (McCain),Rep (Romney),3
nebraska,sioux,600,116,0,716,623,101,11,735,1340,-0.6759776536312849,-0.7209944751381215,Rep (McCain),Rep (Romney),1
nebraska,hayes,460,85,0,545,473,50,12,535,1025,-0.6880733944954128,-0.8087954110898662,Rep (McCain),Rep (Romney),1
nebraska,stanton,1772,657,0,2429,1945,607,71,2623,6207,-0.45903664059283655,-0.524294670846395,Rep (McCain),Rep (Romney),2
nebraska,scottsbluff,9575,4645,0,14220,9427,4193,247,13867,36569,-0.3466947960618847,-0.384287812041116,Rep (McCain),Rep (Romney),6
nebraska,howard,1847,1083,0,2930,1890,914,52,2856,6302,-0.26075085324232083,-0.34807417974322397,Rep (McCain),Rep (Romney),2
nebraska,furnas,1725,556,0,2281,1767,422,26,2215,4942,-0.5124945199473915,-0.6144358154408406,Rep (McCain),Rep (Romney),1
nebraska,grant,321,41,0,362,322,30,11,363,661,-0.7734806629834254,-0.8295454545454546,Rep (McCain),Rep (Romney),1
nebraska,holt,3663,1065,0,4728,3789,862,98,4749,10479,-0.549492385786802,-0.6293270264459256,Rep (McCain),Rep (Romney),3
nebraska,keith,2917,965,0,3882,3036,920,70,4026,8356,-0.502833590932509,-0.5348837209302325,Rep (McCain),Rep (Romney),2
nebraska,cherry,2360,599,0,2959,2557,436,59,3052,5783,-0.5951334910442717,-0.7086535248914133,Rep (McCain),Rep (Romney),2
nebraska,harlan,1327,399,0,1726,1248,311,25,1584,3460,-0.5376593279258401,-0.6010262989095574,Rep (McCain),Rep (Romney),1
nebraska,richardson,1880,1121,0,3001,2407,1180,93,3680,8455,-0.2529156947684105,-0.34206858098689713,Rep (McCain),Rep (Romney),2
nebraska,redwillow,3748,1216,0,4964,3855,940,73,4868,11069,-0.5100725221595488,-0.607924921793535,Rep (McCain),Rep (Romney),3
nebraska,nuckolls,1607,692,0,2299,1563,567,40,2170,4583,-0.3979991300565463,-0.4676056338028169,Rep (McCain),Rep (Romney),1
nebraska,perkins,1086,310,0,1396,1133,237,21,1391,2983,-0.5558739255014327,-0.654014598540146,Rep (McCain),Rep (Romney),1
nebraska,clay,2134,761,0,2895,2213,662,41,2916,6554,-0.47426597582038,-0.5394782608695652,Rep (McCain),Rep (Romney),2
nebraska,dakota,3255,2966,0,6221,3048,2831,98,5977,20674,-0.04645555376949043,-0.03691103929239667,Rep (McCain),Rep (Romney),5
nebraska,adams,8163,4624,0,12787,8235,3991,225,12451,31126,-0.2767654649253148,-0.3471290691967937,Rep (McCain),Rep (Romney),6
nebraska,valley,1647,704,0,2351,1643,494,31,2168,4284,-0.4011059123777116,-0.5376696303228825,Rep (McCain),Rep (Romney),1
nebraska,logan,327,81,0,408,356,68,7,431,682,-0.6029411764705882,-0.6792452830188679,Rep (McCain),Rep (Romney),1
nebraska,blaine,266,43,0,309,268,29,4,301,539,-0.7216828478964401,-0.8047138047138047,Rep (McCain),Rep (Romney),1
nebraska,loup,302,86,0,388,290,62,4,356,635,-0.5567010309278351,-0.6477272727272727,Rep (McCain),Rep (Romney),1
nebraska,thurston,970,1108,0,2078,823,1153,17,1993,6907,0.06641000962463908,0.16700404858299595,Dem (Obama),Dem (Obama),2
nebraska,greeley,714,457,0,1171,820,340,21,1181,2542,-0.21947053800170793,-0.41379310344827586,Rep (McCain),Rep (Romney),1
nebraska,washington,6409,3681,0,10090,6857,3103,161,10121,20148,-0.2703666997026759,-0.37690763052208837,Rep (McCain),Rep (Romney),5
nebraska,sherman,940,583,0,1523,919,549,40,1508,3144,-0.23440577806959947,-0.25204359673024523,Rep (McCain),Rep (Romney),1
nebraska,pawnee,857,481,0,1338,897,396,37,1330,2767,-0.28101644245142005,-0.3874709976798144,Rep (McCain),Rep (Romney),1
nebraska,dawes,2330,1245,0,3575,2435,1102,97,3634,9149,-0.3034965034965035,-0.3768730562623692,Rep (McCain),Rep (Romney),2
nebraska,cuming,2701,1255,0,3956,2858,1015,55,3928,9243,-0.365520728008089,-0.4758585076168345,Rep (McCain),Rep (Romney),2
nebraska,buffalo,12920,5768,0,18688,13378,5266,413,19057,45437,-0.3827054794520548,-0.4350997639991418,Rep (McCain),Rep (Romney),7
nebraska,wheeler,334,96,0,430,345,93,8,446,751,-0.5534883720930233,-0.5753424657534246,Rep (McCain),Rep (Romney),1
nebraska,phelps,3340,1043,0,4383,3372,875,89,4336,9234,-0.5240702715035364,-0.5879444313633153,Rep (McCain),Rep (Romney),2
nebraska,dodge,8482,6587,0,15069,8937,5588,234,14759,36621,-0.12575486097285818,-0.23056798623063685,Rep (McCain),Rep (Romney),7
nebraska,nemaha,2090,1207,0,3297,1979,1089,58,3126,7249,-0.2678192296026691,-0.2900912646675359,Rep (McCain),Rep (Romney),2
nebraska,jefferson,2091,1504,0,3595,2156,1185,75,3416,7708,-0.16328233657858135,-0.290631547440886,Rep (McCain),Rep (Romney),2
nebraska,saline,2373,2597,0,4970,2518,2232,82,4832,14098,0.04507042253521127,-0.06021052631578947,Dem (Obama),Rep (Romney),4
nebraska,hamilton,3362,1322,0,4684,3582,1136,106,4824,9160,-0.43552519214346713,-0.5184400169563375,Rep (McCain),Rep (Romney),2
nebraska,cass,7076,4709,0,11785,7453,4298,201,11952,25246,-0.20084853627492574,-0.2684877882733384,Rep (McCain),Rep (Romney),5
nebraska,frontier,1030,348,0,1378,1005,381,36,1422,2808,-0.4949201741654572,-0.45021645021645024,Rep (McCain),Rep (Romney),1
nebraska,garfield,800,212,0,1012,762,147,19,928,2081,-0.5810276679841897,-0.6765676567656765,Rep (McCain),Rep (Romney),1
nebraska,saunders,6132,3739,0,9871,6725,3279,199,10203,20543,-0.2424273123290447,-0.3444622151139544,Rep (McCain),Rep (Romney),5
nebraska,otoe,3991,2893,0,6884,4226,2542,137,6905,15741,-0.15950029052876236,-0.24881796690307328,Rep (McCain),Rep (Romney),4
nebraska,platte,9279,3734,0,13013,9963,3095,191,13249,31675,-0.42611234918927227,-0.5259610966457344,Rep (McCain),Rep (Romney),6
nebraska,dawson,5368,2352,0,7720,5370,2157,153,7680,24245,-0.39067357512953366,-0.42686329214826624,Rep (McCain),Rep (Romney),5
nebraska,boyd,839,250,0,1089,852,186,9,1047,2107,-0.5408631772268135,-0.6416184971098265,Rep (McCain),Rep (Romney),1
nebraska,arthur,217,39,0,256,227,30,4,261,426,-0.6953125,-0.7665369649805448,Rep (McCain),Rep (Romney),1
nebraska,morrill,1700,546,0,2246,1658,450,44,2152,5071,-0.5138023152270703,-0.573055028462998,Rep (McCain),Rep (Romney),1
nebraska,thomas,331,51,0,382,360,42,6,408,756,-0.7329842931937173,-0.7910447761194029,Rep (McCain),Rep (Romney),1
nebraska,merrick,2356,978,0,3334,2477,921,59,3457,7784,-0.4133173365326935,-0.4579164214243673,Rep (McCain),Rep (Romney),2
nebraska,johnson,1139,914,0,2053,1223,790,44,2057,5211,-0.10959571358986848,-0.21510183805265773,Rep (McCain),Rep (Romney),1
nebraska,dixon,1785,946,0,2731,1745,870,51,2666,6000,-0.3072134749176126,-0.33460803059273425,Rep (McCain),Rep (Romney),2
nebraska,chase,1466,341,0,1807,1573,252,24,1849,3927,-0.6225788599889319,-0.7238356164383561,Rep (McCain),Rep (Romney),1
nebraska,wayne,2503,1249,0,3752,2493,1074,92,3659,9573,-0.3342217484008529,-0.39781328847771236,Rep (McCain),Rep (Romney),3
nebraska,sarpy,38443,27663,0,66106,40318,24709,1139,66166,152180,-0.16307143073246,-0.24003875313331385,Rep (McCain),Rep (Romney),9
nebraska,madison,9542,4076,0,13618,9874,3368,270,13512,34720,-0.40138052577470995,-0.49131551125207673,Rep (McCain),Rep (Romney),6
nebraska,hall,12788,7687,0,20475,12412,6971,338,19721,56899,-0.24913308913308913,-0.2807099004282103,Rep (McCain),Rep (Romney),8
nebraska,cheyenne,3284,1064,0,4348,3134,983,80,4197,10049,-0.5105795768169273,-0.522467816371144,Rep (McCain),Rep (Romney),3
nebraska,knox,2724,1248,0,3972,2878,1055,82,4015,8762,-0.3716012084592145,-0.4635138571065345,Rep (McCain),Rep (Romney),2
nebraska,banner,341,61,0,402,339,55,8,402,720,-0.6965174129353234,-0.7208121827411168,Rep (McCain),Rep (Romney),1
nebraska,franklin,1078,442,0,1520,1110,381,36,1527,3229,-0.41842105263157897,-0.48893360160965793,Rep (McCain),Rep (Romney),1
nebraska,hooker,355,75,0,430,330,59,5,394,690,-0.6511627906976745,-0.6966580976863753,Rep (McCain),Rep (Romney),1
nebraska,hitchcock,997,346,0,1343,1386,310,43,1739,2925,-0.4847356664184661,-0.6344339622641509,Rep (McCain),Rep (Romney),1
nebraska,fillmore,1907,953,0,2860,1972,794,49,2815,5953,-0.33356643356643356,-0.42588575560375996,Rep (McCain),Rep (Romney),2
nebraska,custer,4220,1178,0,5398,4251,1066,97,5414,11001,-0.5635420526120786,-0.5990220048899756,Rep (McCain),Rep (Romney),3
nebraska,brown,1195,306,0,1501,1298,223,24,1545,3192,-0.592271818787475,-0.7067718606180144,Rep (McCain),Rep (Romney),1
nebraska,rock,635,136,0,771,669,103,12,784,1651,-0.6472114137483788,-0.7331606217616581,Rep (McCain),Rep (Romney),1
nebraska,lincoln,10609,4937,0,15546,10545,4350,371,15266,36167,-0.36485269522706804,-0.4159113796576032,Rep (McCain),Rep (Romney),6
nebraska,lancaster,57925,63464,0,121389,61177,59970,2059,123206,279428,0.04563016418291608,-0.009963102676913171,Dem (Obama),Rep (Romney),10
nebraska,boxbutte,2888,1844,0,4732,2795,1634,112,4541,11372,-0.22062552831783602,-0.2621359223300971,Rep (McCain),Rep (Romney),3
nebraska,pierce,2372,781,0,3153,2707,637,70,3414,7308,-0.5045987947986045,-0.6190191387559809,Rep (McCain),Rep (Romney),2
nebraska,thayer,1729,850,0,2579,1853,724,50,2627,5262,-0.3408297789841024,-0.43810632518432285,Rep (McCain),Rep (Romney),2
nevada,douglas,14645,10671,0,25316,16264,9288,502,26054,47042,-0.15697582556486017,-0.27301189730745146,Rep (McCain),Rep (Romney),7
nevada,lander,1462,574,0,2036,1580,534,51,2165,5545,-0.4361493123772102,-0.49479659413434246,Rep (McCain),Rep (Romney),2
nevada,storey,1245,1099,0,2344,1321,920,73,2314,4016,-0.06228668941979522,-0.17893797411869702,Rep (McCain),Rep (Romney),1
nevada,lyon,12154,8405,0,20559,13520,7380,565,21465,51515,-0.18235322729704753,-0.2937799043062201,Rep (McCain),Rep (Romney),7
nevada,humboldt,3584,1909,0,5493,3810,1737,197,5744,15986,-0.3049335517931913,-0.37371552190373175,Rep (McCain),Rep (Romney),4
nevada,nye,9535,7223,0,16758,10566,6320,636,17522,43878,-0.1379639575128297,-0.2514509060760393,Rep (McCain),Rep (Romney),7
nevada,eureka,564,144,0,708,663,107,38,808,1724,-0.5932203389830508,-0.7220779220779221,Rep (McCain),Rep (Romney),1
nevada,elko,10958,4537,0,15495,12013,3510,461,15984,47707,-0.4143917392707325,-0.5477678283836888,Rep (McCain),Rep (Romney),7
nevada,mineral,1131,1082,0,2213,1080,863,92,2035,4812,-0.022141888838680523,-0.1116829644879053,Rep (McCain),Rep (Romney),1
nevada,pershing,1075,673,0,1748,1167,632,85,1884,6703,-0.2299771167048055,-0.2973874374652585,Rep (McCain),Rep (Romney),2
nevada,esmeralda,303,104,0,407,317,92,26,435,892,-0.48894348894348894,-0.5501222493887531,Rep (McCain),Rep (Romney),1
nevada,washoe,76743,99395,0,176138,88151,94806,3960,186917,412844,0.12860370845586983,0.03637466727154468,Dem (Obama),Dem (Obama),10
nevada,carsoncity,11419,11622,0,23041,12394,10290,634,23318,55375,0.008810381493858774,-0.09275260095221301,Dem (Obama),Rep (Romney),8
nevada,churchill,6831,3494,0,10325,7061,2961,243,10265,24946,-0.3231961259079903,-0.4090999800439034,Rep (McCain),Rep (Romney),5
nevada,whitepine,2440,1230,0,3670,2601,983,120,3704,9765,-0.329700272479564,-0.45145089285714285,Rep (McCain),Rep (Romney),3
nevada,lincoln,1498,518,0,2016,1691,400,61,2152,5060,-0.4861111111111111,-0.6174079387852702,Rep (McCain),Rep (Romney),1
nevada,clark,256401,379204,0,635605,288223,387978,12138,688339,1895521,0.19320647257337498,0.14752270404805673,Dem (Obama),Dem (Obama),10
new hampshire,strafford,21767,34087,0,55854,26779,36026,957,63762,122158,0.22057507072009166,0.14723350051747472,Dem (Obama),Dem (Obama),9
new hampshire,coos,6338,9438,0,15776,6342,9091,181,15614,33445,0.19650101419878296,0.1781247975118253,Dem (Obama),Dem (Obama),6
new hampshire,merrimack,32766,43324,0,76090,34451,44635,968,80054,146785,0.1387567354448679,0.12877121108666514,Dem (Obama),Dem (Obama),9
new hampshire,carroll,12578,14089,0,26667,14207,13977,280,28464,47772,0.056661791727603404,-0.00816065852966222,Dem (Obama),Rep (Romney),7
new hampshire,rockingham,80585,82477,0,163062,87809,80096,1889,169794,294638,0.01160294857170892,-0.04593669039039933,Dem (Obama),Rep (Romney),10
new hampshire,belknap,16402,16796,0,33198,17568,15884,319,33771,60142,0.01186818483041147,-0.050340786798995577,Dem (Obama),Rep (Romney),8
new hampshire,hillsborough,85340,93291,0,178631,98103,101499,3163,202765,399555,0.04451075121339521,0.01701385757657739,Dem (Obama),Dem (Obama),10
new hampshire,grafton,15854,28639,0,44493,18207,29826,732,48765,88356,0.28734857168543365,0.24189619636499907,Dem (Obama),Dem (Obama),8
new hampshire,cheshire,13915,25425,0,39340,15135,25329,607,41071,77445,0.2925775292323335,0.2519276393831554,Dem (Obama),Dem (Obama),8
new hampshire,sullivan,9197,13288,0,22485,9269,12166,379,21814,43643,0.18194351790082278,0.1351527874970842,Dem (Obama),Dem (Obama),7
new jersey,middlesex,115969,179924,0,295893,102472,179515,3245,285232,798882,0.21614232171764794,0.27321472266452,Dem (Obama),Dem (Obama),10
new jersey,salem,14763,15909,0,30672,14214,14456,446,29116,65982,0.037363067292644755,0.008440878967561911,Dem (Obama),Dem (Obama),8
new jersey,burlington,83078,121222,0,204300,79110,115951,1998,197059,447861,0.18670582476749878,0.18886912299229472,Dem (Obama),Dem (Obama),10
new jersey,camden,68317,144606,0,212923,63329,137795,2077,203201,513574,0.35829384331424974,0.37024919949881663,Dem (Obama),Dem (Obama),10
new jersey,bergen,174526,208410,0,382936,155267,193470,3286,352023,896482,0.08848475985543276,0.10954673579230194,Dem (Obama),Dem (Obama),10
new jersey,hunterdon,38966,29637,0,68603,36979,25148,694,62821,128458,-0.13598530676501028,-0.19043250116696445,Rep (McCain),Rep (Romney),9
new jersey,atlantic,46244,62498,0,108742,41918,59509,978,102405,273162,0.14947306468521823,0.1734350813885849,Dem (Obama),Dem (Obama),10
new jersey,morris,122706,101245,0,223951,114265,90313,2002,206580,489811,-0.09582899830766552,-0.11708003793174242,Rep (McCain),Rep (Romney),10
new jersey,mercer,46834,98914,0,145748,43155,94300,1609,139064,364445,0.3573290885638225,0.37208540977047033,Dem (Obama),Dem (Obama),10
new jersey,monmouth,159461,147424,0,306885,140376,125471,3096,268943,628112,-0.03922316177069586,-0.05606608312299932,Rep (McCain),Rep (Romney),10
new jersey,passaic,71850,110331,0,182181,59181,104057,1391,164629,496204,0.21122400250300524,0.2749114789448535,Dem (Obama),Dem (Obama),10
new jersey,warren,27304,20421,0,47725,24695,17869,748,43312,108982,-0.1442221058145626,-0.16037026595244808,Rep (McCain),Rep (Romney),9
new jersey,hudson,51478,141557,0,193035,38082,136239,1783,176104,622123,0.4666459450358743,0.5630819006315935,Dem (Obama),Dem (Obama),10
new jersey,cumberland,22238,34355,0,56593,18767,30172,533,49472,155456,0.21410775184210062,0.2330452195590429,Dem (Obama),Dem (Obama),9
new jersey,somerset,67221,73785,0,141006,63159,70168,1605,134932,319347,0.04655121058678354,0.052569997074861055,Dem (Obama),Dem (Obama),10
new jersey,capemay,24591,20510,0,45101,25488,21275,480,47243,97684,-0.0904857985410523,-0.0900925945726322,Rep (McCain),Rep (Romney),9
new jersey,gloucester,60017,76789,0,136806,58915,72960,1693,133568,285223,0.12259696212154438,0.10650236966824644,Dem (Obama),Dem (Obama),10
new jersey,ocean,159480,109240,0,268720,138594,96500,2338,237432,569374,-0.18696040488240548,-0.17905178354190238,Rep (McCain),Rep (Romney),10
new jersey,essex,67899,216459,0,284358,61595,217950,2088,281633,780872,0.5224400227881755,0.5593196086497702,Dem (Obama),Dem (Obama),10
new jersey,union,73967,132006,0,205973,66457,134220,1676,202353,529547,0.28177965073092104,0.337671980346527,Dem (Obama),Dem (Obama),10
new jersey,sussex,43998,28692,0,72690,37215,23406,1083,61704,149996,-0.21056541477507223,-0.22779234918592567,Rep (McCain),Rep (Romney),9
new mexico,torrance,3721,3068,0,6789,3521,2414,441,6376,16467,-0.09618500515539843,-0.1865206402695872,Rep (McCain),Rep (Romney),4
new mexico,sanjuan,23724,16084,0,39808,28779,15688,1527,45994,127517,-0.19192122186495178,-0.2943980929678188,Rep (McCain),Rep (Romney),9
new mexico,catron,1395,660,0,2055,1474,557,69,2100,3652,-0.35766423357664234,-0.45150172328902016,Rep (McCain),Rep (Romney),1
new mexico,hidalgo,934,990,0,1924,895,994,40,1929,4964,0.029106029106029108,0.05240868184224457,Dem (Obama),Dem (Obama),1
new mexico,socorro,2875,4142,0,7017,2698,3983,406,7087,17964,0.18056149351574746,0.19233647657536296,Dem (Obama),Dem (Obama),4
new mexico,santafe,15443,53802,0,69245,15145,49668,2811,67624,141702,0.5539605747707416,0.5326554857821734,Dem (Obama),Dem (Obama),9
new mexico,colfax,2800,3465,0,6265,2763,2879,254,5896,13827,0.10614525139664804,0.02056008507621411,Dem (Obama),Dem (Obama),3
new mexico,grant,5381,8092,0,13473,5286,7009,449,12744,29706,0.2012172493134417,0.14013826758845058,Dem (Obama),Dem (Obama),6
new mexico,valencia,13033,15142,0,28175,12788,13473,1386,27647,74554,0.07485359361135759,0.026084307528273867,Dem (Obama),Dem (Obama),8
new mexico,otero,12791,8602,0,21393,12219,6715,709,19643,62782,-0.19581171411209275,-0.2906939896482518,Rep (McCain),Rep (Romney),8
new mexico,eddy,10774,5817,0,16591,12546,6110,539,19195,52665,-0.298776445060575,-0.3449828473413379,Rep (McCain),Rep (Romney),8
new mexico,chaves,13630,8160,0,21790,13271,6621,606,20498,64268,-0.2510325837540156,-0.33430524834104164,Rep (McCain),Rep (Romney),8
new mexico,curry,9585,4655,0,14240,9150,3956,344,13450,46924,-0.34620786516853935,-0.39630703494582636,Rep (McCain),Rep (Romney),7
new mexico,bernalillo,108314,166512,0,274826,104242,147183,13517,264942,646881,0.21176307918464773,0.170790494183156,Dem (Obama),Dem (Obama),10
new mexico,cibola,1717,3176,0,4893,2966,4907,281,8154,27179,0.2981810750051093,0.24653880350565222,Dem (Obama),Dem (Obama),6
new mexico,rioarriba,3648,11245,0,14893,3373,11389,477,15239,40195,0.5101054186530585,0.5430158515106354,Dem (Obama),Dem (Obama),7
new mexico,sandoval,24887,32102,0,56989,24124,26831,2406,53361,124263,0.12660337959957185,0.053125306643116474,Dem (Obama),Dem (Obama),9
new mexico,luna,3857,4289,0,8146,3654,3573,245,7472,25252,0.05303216302479745,-0.0112079701120797,Dem (Obama),Rep (Romney),5
new mexico,donaana,27211,38574,0,65785,26988,36778,1946,65712,NA,0.1727293455955005,0.15353009440767806,Dem (Obama),Dem (Obama),NA
new mexico,sanmiguel,2421,10128,0,12549,2281,8754,353,11388,29321,0.6141525221133158,0.586588128681468,Dem (Obama),Dem (Obama),6
new mexico,debaca,676,358,0,1034,586,287,27,900,1772,-0.30754352030947774,-0.3424971363115693,Rep (McCain),Rep (Romney),1
new mexico,harding,357,256,0,613,326,260,14,600,943,-0.16476345840130505,-0.11262798634812286,Rep (McCain),Rep (Romney),1
new mexico,sierra,3011,2351,0,5362,2928,1963,210,5101,11938,-0.12308839985080194,-0.19730116540584747,Rep (McCain),Rep (Romney),3
new mexico,lea,13165,6048,0,19213,12480,4068,385,16933,62503,-0.3704262738770624,-0.508339376359681,Rep (McCain),Rep (Romney),8
new mexico,quay,2363,1546,0,3909,2194,1382,120,3696,9002,-0.20900486057815298,-0.22706935123042504,Rep (McCain),Rep (Romney),2
new mexico,guadalupe,615,1541,0,2156,518,1388,72,1978,4698,0.4294990723562152,0.4564533053515215,Dem (Obama),Dem (Obama),1
new mexico,taos,2827,13384,0,16211,2710,11855,623,15188,32574,0.6512244772068349,0.6278750429110882,Dem (Obama),Dem (Obama),6
new mexico,roosevelt,4285,2270,0,6555,4032,1719,198,5949,19372,-0.30739893211289093,-0.40219092331768386,Rep (McCain),Rep (Romney),5
new mexico,mckinley,6183,15993,0,22176,5420,15363,530,21313,70663,0.44237012987012986,0.47841986238752826,Dem (Obama),Dem (Obama),8
new mexico,union,1218,492,0,1710,1231,471,51,1753,4388,-0.4245614035087719,-0.44653349001175086,Rep (McCain),Rep (Romney),1
new mexico,mora,565,2156,0,2721,591,1952,61,2604,4923,0.5847115031238516,0.5351946519858435,Dem (Obama),Dem (Obama),1
new mexico,lincoln,5906,3482,0,9388,5940,2931,338,9209,20502,-0.2582019599488709,-0.3391951301995266,Rep (McCain),Rep (Romney),5
new mexico,losalamos,4986,5709,0,10695,4796,5191,667,10654,18091,0.06760168302945302,0.03955141684189446,Dem (Obama),Dem (Obama),4
new york,suffolk,289236,318920,0,608156,259348,274830,6475,540653,1482548,0.04880984484244174,0.028982848413824605,Dem (Obama),Dem (Obama),10
new york,schenectady,28172,35529,0,63701,24608,33777,1229,59614,153268,0.11549269242241095,0.15704376124004454,Dem (Obama),Dem (Obama),9
new york,albany,47629,86096,0,133725,42029,80891,2611,125531,304032,0.287657506075902,0.3161568499837293,Dem (Obama),Dem (Obama),10
new york,delaware,9765,8562,0,18327,9085,7469,362,16916,48220,-0.06564085775085939,-0.09761991059562644,Rep (McCain),Rep (Romney),7
new york,richmond,80853,73192,0,154045,NA,NA,NA,NA,463450,-0.04973222110422279,NA,Rep (McCain),NA,10
new york,ontario,23000,22797,0,45797,21998,21285,861,44144,106298,-0.004432604755770029,-0.016472980153871036,Rep (McCain),Rep (Romney),9
new york,kings,139594,545785,0,685379,NA,NA,NA,NA,2466782,0.5926516569664375,NA,Dem (Obama),NA,10
new york,schuyler,4431,3792,0,8223,3942,3354,168,7464,18566,-0.07770886537759941,-0.0805921052631579,Rep (McCain),Rep (Romney),4
new york,herkimer,13213,10920,0,24133,12389,10433,468,23290,64332,-0.09501512451829446,-0.08570677416527912,Rep (McCain),Rep (Romney),8
new york,bronx,38560,300327,0,338887,26304,288378,1365,316047,1365725,0.7724315184707586,0.8328217057219669,Dem (Obama),Dem (Obama),10
new york,greene,11992,9611,0,21603,9935,7911,417,18263,49410,-0.11021617367958154,-0.11341477081698981,Rep (McCain),Rep (Romney),7
new york,broome,37773,43510,0,81283,34878,38315,2051,75244,200804,0.07058056420161657,0.04695804243575205,Dem (Obama),Dem (Obama),10
new york,ulster,31394,50300,0,81694,27340,43164,1689,72193,182782,0.23142458442480476,0.22444116645864065,Dem (Obama),Dem (Obama),9
new york,lewis,5700,4813,0,10513,5083,4263,135,9481,27017,-0.08437173023875202,-0.08773806976246523,Rep (McCain),Rep (Romney),6
new york,queens,144362,436398,0,580760,103193,399970,4559,507722,2199169,0.5028514360493147,0.5898227810868446,Dem (Obama),Dem (Obama),10
new york,stlawrence,15972,21642,0,37614,NA,NA,NA,NA,111778,0.15074174509491148,NA,Dem (Obama),NA,9
new york,columbia,12851,15536,0,28387,11194,14244,570,26008,63241,0.09458554972346496,0.11989936315748094,Dem (Obama),Dem (Obama),8
new york,chautauqua,26593,26936,0,53529,25795,21815,824,48434,135263,0.006407741598012292,-0.08359588321781139,Dem (Obama),Rep (Romney),9
new york,steuben,22690,15823,0,38513,20425,14586,648,35659,98724,-0.17830343001064575,-0.16677615606523663,Rep (McCain),Rep (Romney),9
new york,orange,66512,68160,0,134672,60984,67709,1801,130494,370201,0.01223713912320304,0.052256144467842075,Dem (Obama),Dem (Obama),10
new york,seneca,6556,6903,0,13459,5405,6526,217,12148,35309,0.025782004606582955,0.09395691895063281,Dem (Obama),Dem (Obama),6
new york,newyork,79448,490634,0,570082,261264,1008250,14120,1283634,1583345,0.7212751849733898,0.5884031211944099,Dem (Obama),Dem (Obama),10
new york,oswego,21909,23078,0,44987,18503,21733,897,41133,122220,0.02598528463778425,0.08027636942041952,Dem (Obama),Dem (Obama),9
new york,yates,4784,4390,0,9174,4270,4021,146,8437,25250,-0.042947460213647266,-0.030032565432396574,Rep (McCain),Rep (Romney),5
new york,washington,11717,11867,0,23584,10254,10596,413,21263,63088,0.006360244233378561,0.016402877697841725,Dem (Obama),Dem (Obama),8
new york,westchester,142560,247476,0,390036,108707,171908,4116,284731,939406,0.268990554718026,0.22522317053614382,Dem (Obama),Dem (Obama),10
new york,erie,154716,218645,0,373361,159678,220184,6803,386665,921202,0.17122570380944985,0.1592841610900801,Dem (Obama),Dem (Obama),10
new york,clinton,11535,18232,0,29767,10054,17123,445,27622,82380,0.22498068330701784,0.2601096515435847,Dem (Obama),Dem (Obama),8
new york,monroe,139001,196564,0,335565,124769,178491,5665,308925,741274,0.1715405361107386,0.17714832157224825,Dem (Obama),Dem (Obama),10
new york,wyoming,10487,6035,0,16522,9726,5224,280,15230,42367,-0.2694589032804745,-0.3011371237458194,Rep (McCain),Rep (Romney),7
new york,jefferson,18593,16222,0,34815,16279,15345,427,32051,115069,-0.06810282924027,-0.02953453073614976,Rep (McCain),Rep (Romney),9
new york,niagara,43748,44105,0,87853,40397,40862,1461,82720,216064,0.0040636062513516895,0.005722443052461881,Dem (Obama),Dem (Obama),10
new york,chenango,9708,9256,0,18964,8933,8340,382,17655,51045,-0.02383463404345075,-0.03433103687836508,Rep (McCain),Rep (Romney),7
new york,schoharie,7520,5760,0,13280,6849,4862,232,11943,32789,-0.13253012048192772,-0.16966954145675006,Rep (McCain),Rep (Romney),6
new york,rensselaer,31126,36550,0,67676,27240,34713,1379,63332,158629,0.08014658076718482,0.12062369861023679,Dem (Obama),Dem (Obama),9
new york,hamilton,1903,1060,0,2963,1652,955,48,2655,4908,-0.2845089436382045,-0.26735711545838126,Rep (McCain),Rep (Romney),1
new york,fulton,11537,9147,0,20684,9811,7916,313,18040,55497,-0.11554824985496036,-0.10689908049867435,Rep (McCain),Rep (Romney),8
new york,nassau,272765,316523,0,589288,212882,243649,4293,460824,1329083,0.07425571197784445,0.06739301383695741,Dem (Obama),Dem (Obama),10
new york,rockland,58199,65134,0,123333,52936,60446,1118,114500,305461,0.05622988170238298,0.06623626325166253,Dem (Obama),Dem (Obama),10
new york,warren,14422,14416,0,28838,12571,13112,537,26220,65707,-2.0805881129065817e-4,0.021064517385040688,Rep (McCain),Dem (Obama),8
new york,oneida,46555,45531,0,92086,41639,37388,1402,80429,234533,-0.011120039962643616,-0.053791742062839286,Rep (McCain),Rep (Romney),10
new york,putnam,23545,19371,0,42916,22436,17851,596,40883,99545,-0.09725976325845838,-0.1138084245538263,Rep (McCain),Rep (Romney),9
new york,onondaga,80476,118390,0,198866,72807,112664,3316,188787,463704,0.1906509911196484,0.21489612931401675,Dem (Obama),Dem (Obama),10
new york,cayuga,14283,16667,0,30950,11355,14162,556,26073,80431,0.07702746365105008,0.11000509464278717,Dem (Obama),Dem (Obama),8
new york,cattaraugus,16975,13858,0,30833,15406,11695,507,27608,80776,-0.10109298478902475,-0.13693221652337553,Rep (McCain),Rep (Romney),8
new york,otsego,11059,12072,0,23131,10527,10975,436,21938,62604,0.04379404262677792,0.020835271137568598,Dem (Obama),Dem (Obama),8
new york,dutchess,55601,64759,0,120360,52320,59885,1937,114142,296152,0.07608840146227983,0.06742123791274898,Dem (Obama),Dem (Obama),10
new york,cortland,8970,10616,0,19586,7886,9445,367,17698,49452,0.08403962013683243,0.08995441694074202,Dem (Obama),Dem (Obama),7
new york,orleans,9166,6142,0,15308,8076,5411,269,13756,43169,-0.19754376796446302,-0.19759768666122934,Rep (McCain),Rep (Romney),7
new york,genesee,14573,10029,0,24602,13701,8886,492,23079,59952,-0.18470043085927973,-0.21317572054721742,Rep (McCain),Rep (Romney),8
new york,chemung,18793,17706,0,36499,16207,15285,489,31981,88708,-0.029781637853091864,-0.02927727676870316,Rep (McCain),Rep (Romney),8
new york,wayne,21083,16831,0,37914,18315,15136,676,34127,93654,-0.11214854671097747,-0.0950345281157514,Rep (McCain),Rep (Romney),9
new york,sullivan,13312,15850,0,29162,11148,13781,393,25322,77625,0.08703106782799534,0.10561996068835493,Dem (Obama),Dem (Obama),8
new york,madison,13560,13299,0,26859,12611,12698,556,25865,72887,-0.009717413157600803,0.0034375123473863053,Rep (McCain),Dem (Obama),8
new york,montgomery,10428,8592,0,19020,8622,7881,281,16784,49945,-0.09652996845425868,-0.04490092710416288,Rep (McCain),Rep (Romney),7
new york,franklin,6245,9593,0,15838,5248,9065,224,14537,51697,0.21139032706149766,0.2666806399776427,Dem (Obama),Dem (Obama),7
new york,tioga,12077,9702,0,21779,11278,8263,436,19977,51377,-0.10905000229578952,-0.15429097794381044,Rep (McCain),Rep (Romney),7
new york,saratoga,49734,51932,0,101666,46829,48876,1797,97502,217264,0.02161981390041902,0.021388642181704196,Dem (Obama),Dem (Obama),10
new york,essex,7189,9531,0,16720,6495,8835,247,15577,39416,0.14007177033492824,0.15264187866927592,Dem (Obama),Dem (Obama),7
new york,livingston,15906,13446,0,29352,13210,10889,507,24606,65441,-0.08381030253475061,-0.09631105025104776,Rep (McCain),Rep (Romney),8
new york,allegany,10308,6396,0,16704,9609,5658,334,15601,49105,-0.23419540229885058,-0.25879347612497544,Rep (McCain),Rep (Romney),7
new york,tompkins,11004,26401,0,37405,10202,24447,1176,35825,100612,0.411629461301965,0.41112297613206733,Dem (Obama),Dem (Obama),9
north carolina,cleveland,25950,17274,0,43224,25440,16734,368,42542,97786,-0.20072182121043863,-0.20643050220515008,Rep (McCain),Rep (Romney),9
north carolina,lenoir,13281,13157,0,26438,13763,13350,134,27247,59307,-0.004690218624706861,-0.015232545273485044,Rep (McCain),Rep (Romney),8
north carolina,haywood,14790,12611,0,27401,15553,11742,384,27679,58597,-0.07952264515893581,-0.13962264150943396,Rep (McCain),Rep (Romney),8
north carolina,graham,2808,1264,0,4072,2743,1115,52,3910,8702,-0.3791748526522593,-0.42198030067392434,Rep (McCain),Rep (Romney),2
north carolina,pasquotank,7720,10170,0,17890,7216,9970,157,17343,40167,0.1369480156512018,0.16024671244035843,Dem (Obama),Dem (Obama),7
north carolina,richmond,9317,9586,0,18903,9236,9747,144,19127,46477,0.014230545416071523,0.02691882210398778,Dem (Obama),Dem (Obama),7
north carolina,polk,6511,4723,0,11234,6219,4000,104,10323,20289,-0.15915969378671888,-0.2171445346902828,Rep (McCain),Rep (Romney),5
north carolina,granville,11375,13011,0,24386,12332,13529,207,26068,58071,0.06708767325514639,0.04628591315107691,Dem (Obama),Dem (Obama),8
north carolina,columbus,12998,11088,0,24086,12863,10973,181,24017,56856,-0.07929917794569459,-0.07929182748783353,Rep (McCain),Rep (Romney),8
north carolina,chowan,3751,3652,0,7403,3872,3507,45,7424,14859,-0.01337295690936107,-0.04946469711343,Rep (McCain),Rep (Romney),4
north carolina,avery,5619,2163,0,7782,5708,1861,88,7657,17951,-0.4441017733230532,-0.5082573655700885,Rep (McCain),Rep (Romney),4
north carolina,onslow,28240,18610,0,46850,31695,18115,543,50353,169207,-0.20554962646744931,-0.2726360168640835,Rep (McCain),Rep (Romney),9
north carolina,lee,12652,10703,0,23355,13000,10577,223,23800,55576,-0.08345108113894241,-0.10276964838613903,Rep (McCain),Rep (Romney),8
north carolina,gates,844,1587,0,2431,2532,2745,33,5310,12039,0.30563554092965856,0.04036384309266629,Dem (Obama),Dem (Obama),3
north carolina,duplin,10734,8866,0,19600,11330,8923,122,20375,56657,-0.0953061224489796,-0.11884659062854885,Rep (McCain),Rep (Romney),8
north carolina,currituck,7159,3685,0,10844,7431,3521,201,11153,23299,-0.3203614902250092,-0.3570124178232286,Rep (McCain),Rep (Romney),5
north carolina,mcdowell,11382,6514,0,17896,11732,6006,215,17953,44593,-0.2720160929816719,-0.3228097868981847,Rep (McCain),Rep (Romney),7
north carolina,jones,2807,2364,0,5171,2825,2335,32,5192,10060,-0.08567008315606266,-0.09496124031007752,Rep (McCain),Rep (Romney),3
north carolina,greene,4258,3774,0,8032,4393,3761,40,8194,21157,-0.0602589641434263,-0.07750797154770665,Rep (McCain),Rep (Romney),5
north carolina,dare,9621,7760,0,17381,10102,7258,254,17614,33650,-0.10707093953167252,-0.16382488479262672,Rep (McCain),Rep (Romney),6
north carolina,johnston,43156,26477,0,69633,48206,27052,763,76021,160675,-0.23952723564976375,-0.2810863961306439,Rep (McCain),Rep (Romney),9
north carolina,yadkin,12355,4501,0,16856,12500,3928,229,16657,38158,-0.4659468438538206,-0.5217920623326029,Rep (McCain),Rep (Romney),7
north carolina,moore,27165,17534,0,44699,29336,16371,337,46044,85914,-0.21546343318642475,-0.2836545824490778,Rep (McCain),Rep (Romney),8
north carolina,newhanover,50004,48588,0,98592,52792,48038,1237,102067,197272,-0.01436222005842259,-0.04714866607160567,Rep (McCain),Rep (Romney),10
north carolina,pamlico,3809,2820,0,6629,4032,2632,48,6712,13072,-0.1491929401116307,-0.21008403361344538,Rep (McCain),Rep (Romney),3
north carolina,cabarrus,45340,31191,0,76531,49125,32453,867,82445,169990,-0.18487932994472828,-0.20436882492828948,Rep (McCain),Rep (Romney),9
north carolina,iredell,44979,27201,0,72180,49071,25952,739,75762,154632,-0.24630091438071489,-0.3081588312917372,Rep (McCain),Rep (Romney),9
north carolina,durham,32040,102237,0,134277,33326,109185,1317,143828,258578,0.522777541946871,0.5323027696107668,Dem (Obama),Dem (Obama),10
north carolina,henderson,30783,19996,0,50779,32860,18519,582,51961,103881,-0.2124303353748597,-0.27912182019891396,Rep (McCain),Rep (Romney),9
north carolina,brunswick,30662,21280,0,51942,34587,21932,466,56985,101994,-0.18062454275923145,-0.2239070047240751,Rep (McCain),Rep (Romney),9
north carolina,caswell,5177,5466,0,10643,5471,5183,82,10736,23848,0.027153997932913652,-0.02703210061948564,Dem (Obama),Rep (Romney),5
north carolina,wilson,18338,19754,0,38092,17904,20745,241,38890,79533,0.03717315971857608,0.07350772335636109,Dem (Obama),Dem (Obama),8
north carolina,orange,20226,53712,0,73938,21398,53404,1046,75848,129562,0.4528929643755579,0.4278762599930483,Dem (Obama),Dem (Obama),9
north carolina,alexander,11747,5153,0,16900,12207,4591,262,17060,36797,-0.3901775147928994,-0.45338730801285865,Rep (McCain),Rep (Romney),7
north carolina,vance,7584,13110,0,20694,7406,13286,78,20770,44975,0.267033922876196,0.28416779431664413,Dem (Obama),Dem (Obama),7
north carolina,person,10007,8410,0,18417,10467,8384,157,19008,38942,-0.0867133626540696,-0.11049811681077927,Rep (McCain),Rep (Romney),7
north carolina,bertie,3338,6248,0,9586,3367,6537,37,9941,20890,0.3035677029000626,0.32007269789983844,Dem (Obama),Dem (Obama),5
north carolina,scotland,5972,8105,0,14077,5799,8131,90,14020,36325,0.15152376216523408,0.16740847092605887,Dem (Obama),Dem (Obama),6
north carolina,macon,10262,6603,0,16865,10817,5692,241,16750,33453,-0.21695819745034095,-0.3104367314797989,Rep (McCain),Rep (Romney),6
north carolina,davidson,45135,22192,0,67327,48935,20291,768,69994,160638,-0.3407696763556968,-0.41377517117845897,Rep (McCain),Rep (Romney),9
north carolina,camden,3118,1587,0,4705,2995,1456,69,4520,9719,-0.32539851222104144,-0.3457649966299708,Rep (McCain),Rep (Romney),3
north carolina,sampson,13952,11753,0,25705,14358,11496,151,26005,62832,-0.08554755884069247,-0.11069853794383848,Rep (McCain),Rep (Romney),8
north carolina,forsyth,73304,90712,0,164016,79177,91606,1549,172332,342989,0.10613598673300166,0.07277656441214875,Dem (Obama),Dem (Obama),10
north carolina,clay,3692,1731,0,5423,3952,1573,67,5592,10418,-0.3616079660704407,-0.43058823529411766,Rep (McCain),Rep (Romney),3
north carolina,burke,21766,14623,0,36389,22109,13577,430,36116,90557,-0.19629558383027837,-0.2390853556016365,Rep (McCain),Rep (Romney),9
north carolina,randolph,40644,16280,0,56924,44913,14675,614,60202,140034,-0.42800927552526175,-0.5074511646640263,Rep (McCain),Rep (Romney),9
north carolina,nash,23660,23013,0,46673,23769,24214,252,48235,94402,-0.013862404387975917,0.009274117916762187,Rep (McCain),Dem (Obama),9
north carolina,hyde,1203,1225,0,2428,1183,1157,18,2358,5721,0.009060955518945634,-0.011111111111111112,Dem (Obama),Rep (Romney),2
north carolina,carteret,22868,11079,0,33947,24598,10197,329,35124,65068,-0.3472766371107904,-0.41388130478517027,Rep (McCain),Rep (Romney),8
north carolina,alamance,34501,28590,0,63091,37712,28341,585,66638,147072,-0.09369006672901048,-0.14187092183549574,Rep (McCain),Rep (Romney),9
north carolina,stanly,19193,8815,0,28008,19698,8287,291,28276,60109,-0.37053698943159097,-0.40775415401107734,Rep (McCain),Rep (Romney),8
north carolina,rockingham,22435,16730,0,39165,25037,16170,342,41549,93322,-0.1456657730116175,-0.21518188657266968,Rep (McCain),Rep (Romney),9
north carolina,craven,23163,17335,0,40498,26654,18556,375,45585,100001,-0.14390834115264953,-0.17911966379119665,Rep (McCain),Rep (Romney),9
north carolina,ashe,7885,4861,0,12746,8207,4100,179,12486,26787,-0.2372509022438412,-0.3337125213293248,Rep (McCain),Rep (Romney),6
north carolina,cherokee,8591,3748,0,12339,9201,3339,155,12695,27317,-0.3924953399789286,-0.46746411483253586,Rep (McCain),Rep (Romney),6
north carolina,pitt,33429,39763,0,73192,35534,40701,579,76814,161385,0.08653951251502896,0.06777726765921165,Dem (Obama),Dem (Obama),9
north carolina,jackson,7793,8671,0,16464,8224,8052,280,16556,39144,0.053328474246841596,-0.010567707053330056,Dem (Obama),Rep (Romney),7
north carolina,washington,2667,3734,0,6401,2615,3811,30,6456,13248,0.1666927042649586,0.18611889200124493,Dem (Obama),Dem (Obama),3
north carolina,mitchell,5472,2220,0,7692,5778,1810,85,7673,15680,-0.42277691107644305,-0.5229309435951502,Rep (McCain),Rep (Romney),4
north carolina,mecklenburg,152957,252642,0,405599,170490,270705,3867,445062,882761,0.2457723021999561,0.22714445993268284,Dem (Obama),Dem (Obama),10
north carolina,wake,183291,247914,0,431205,232933,286939,6933,526805,850546,0.14986607298152851,0.10388326357257172,Dem (Obama),Dem (Obama),10
north carolina,stokes,14335,6816,0,21151,15142,5969,285,21396,47194,-0.35549146612453314,-0.43451281322533275,Rep (McCain),Rep (Romney),7
north carolina,buncombe,52236,69415,0,121651,54429,70066,1706,126201,233249,0.1412154441804835,0.12560343788907186,Dem (Obama),Dem (Obama),10
north carolina,pender,13517,9832,0,23349,14368,9455,213,24036,50256,-0.15782260482247634,-0.20622927423078538,Rep (McCain),Rep (Romney),7
north carolina,wilkes,20152,8889,0,29041,20410,8089,353,28852,69063,-0.38783099755518063,-0.43233095898101687,Rep (McCain),Rep (Romney),8
north carolina,warren,2992,6663,0,9655,3111,6635,31,9777,20810,0.38021750388399794,0.3615842396880772,Dem (Obama),Dem (Obama),5
north carolina,surry,18453,10279,0,28732,19753,9005,338,29096,73287,-0.28449115968258387,-0.3737394811878434,Rep (McCain),Rep (Romney),8
north carolina,rutherford,18631,9595,0,28226,18797,9277,299,28373,66928,-0.3201303762488486,-0.3391037971076441,Rep (McCain),Rep (Romney),8
north carolina,rowan,37284,23272,0,60556,38622,22529,652,61803,136880,-0.2313891274192483,-0.2631682229235826,Rep (McCain),Rep (Romney),9
north carolina,robeson,16561,22146,0,38707,17093,23957,330,41380,131708,0.14428914666597772,0.16721071863581,Dem (Obama),Dem (Obama),9
north carolina,beaufort,13437,9426,0,22863,13918,9399,151,23468,47185,-0.1754362944495473,-0.1938070935369044,Rep (McCain),Rep (Romney),7
north carolina,cumberland,51596,73926,0,125522,50191,74991,910,126092,312994,0.17789710170328707,0.19811154958380597,Dem (Obama),Dem (Obama),10
north carolina,anson,4067,6293,0,10360,4125,6894,53,11072,26785,0.21486486486486486,0.2512932208004356,Dem (Obama),Dem (Obama),6
north carolina,transylvania,9257,7180,0,16437,9522,6740,207,16469,32404,-0.12636125813712965,-0.1710736686754397,Rep (McCain),Rep (Romney),6
north carolina,yancey,5021,4470,0,9491,5249,3954,141,9344,17911,-0.058054999473185126,-0.14071498424426818,Rep (McCain),Rep (Romney),4
north carolina,hoke,6197,9133,0,15330,6721,9915,164,16800,44128,0.19151989562948468,0.19199326761240681,Dem (Obama),Dem (Obama),7
north carolina,edgecombe,8416,17365,0,25781,8494,18249,83,26826,56247,0.3471160932469648,0.36476835059641777,Dem (Obama),Dem (Obama),8
north carolina,swain,2896,2803,0,5699,2976,2618,111,5705,13861,-0.016318652395157045,-0.06399713979263497,Rep (McCain),Rep (Romney),4
north carolina,gaston,52220,31247,0,83467,55817,32903,918,89638,202642,-0.25127295817508716,-0.258273219116321,Rep (McCain),Rep (Romney),10
north carolina,caldwell,22397,12007,0,34404,23069,10795,474,34338,82162,-0.30199976746889895,-0.36244979919678716,Rep (McCain),Rep (Romney),8
north carolina,perquimans,3674,2761,0,6435,3814,2747,60,6621,13091,-0.14188034188034188,-0.16262764822435605,Rep (McCain),Rep (Romney),3
north carolina,halifax,8867,15726,0,24593,8686,16931,107,25724,55293,0.27890050014231693,0.32185657961509934,Dem (Obama),Dem (Obama),8
north carolina,wayne,26800,22507,0,49307,27536,23154,298,50988,120102,-0.0870667450869045,-0.08644703097257841,Rep (McCain),Rep (Romney),9
north carolina,hertford,3083,7479,0,10562,3001,7815,56,10872,24384,0.41620905131603864,0.44508136094674555,Dem (Obama),Dem (Obama),5
north carolina,martin,5914,6488,0,12402,5963,6514,64,12541,24471,0.046282857603612323,0.04416125671235072,Dem (Obama),Dem (Obama),5
north carolina,madison,5175,5011,0,10186,5379,4466,178,10023,20549,-0.01610053013940703,-0.09273743016759776,Rep (McCain),Rep (Romney),5
north carolina,catawba,42843,25535,0,68378,44386,23954,762,69102,153149,-0.2531223492936325,-0.2989757096868598,Rep (McCain),Rep (Romney),9
north carolina,alleghany,3117,2017,0,5134,3378,1574,73,5025,11084,-0.21425788858589795,-0.364297253634895,Rep (McCain),Rep (Romney),3
north carolina,northampton,3662,6893,0,10555,3474,7210,35,10719,22161,0.3061108479393652,0.3496817671284163,Dem (Obama),Dem (Obama),5
north carolina,chatham,14591,17783,0,32374,16578,18252,327,35157,61426,0.09859764008154692,0.04806201550387597,Dem (Obama),Dem (Obama),8
north carolina,montgomery,6125,4870,0,10995,6389,4689,100,11178,27611,-0.11414279217826284,-0.15345730276223146,Rep (McCain),Rep (Romney),6
north carolina,franklin,12883,13026,0,25909,14480,13317,262,28059,58473,0.0055193176116407425,-0.04183904737921358,Dem (Obama),Rep (Romney),8
north carolina,davie,13846,6102,0,19948,14568,5652,198,20418,40581,-0.38820934429516746,-0.44094955489614246,Rep (McCain),Rep (Romney),7
north carolina,harnett,23311,16519,0,39830,25070,16858,415,42343,109031,-0.17052473010293748,-0.1958595687845831,Rep (McCain),Rep (Romney),9
north carolina,union,53721,30945,0,84666,60468,32032,889,93389,190346,-0.26900999220466304,-0.30741621621621623,Rep (McCain),Rep (Romney),9
north carolina,lincoln,24603,12180,0,36783,25184,10980,368,36532,75697,-0.33773754179920074,-0.39276628691516424,Rep (McCain),Rep (Romney),8
north carolina,watauga,13303,14513,0,27816,14124,13371,673,28168,49705,0.04350014380212827,-0.027386797599563556,Dem (Obama),Rep (Romney),7
north carolina,tyrrell,959,932,0,1891,929,835,11,1775,4374,-0.014278159703860392,-0.05328798185941043,Rep (McCain),Rep (Romney),1
north carolina,guilford,97349,141411,0,238760,103964,145483,2082,251529,475786,0.1845451499413637,0.16644417451402502,Dem (Obama),Dem (Obama),10
north carolina,bladen,7530,7846,0,15376,7947,8277,127,16351,34629,0.020551508844953173,0.020340236686390532,Dem (Obama),Dem (Obama),6
north dakota,ramsey,2358,2311,0,4669,2659,2162,150,4971,11371,-0.010066395373741701,-0.10309064509437876,Rep (McCain),Rep (Romney),3
north dakota,wells,1468,840,0,2308,1646,671,42,2359,4276,-0.2720970537261698,-0.4208027621924903,Rep (McCain),Rep (Romney),1
north dakota,walsh,2410,2323,0,4733,2809,2118,134,5061,11286,-0.01838157616733573,-0.14024761518165213,Rep (McCain),Rep (Romney),3
north dakota,richland,3892,3510,0,7402,4213,3190,146,7549,16507,-0.05160767360172926,-0.13818722139673106,Rep (McCain),Rep (Romney),4
north dakota,grandforks,14498,16079,0,30577,15044,14008,744,29796,66771,0.0517055303005527,-0.03566019551149663,Dem (Obama),Rep (Romney),8
north dakota,barnes,2808,2723,0,5531,2953,2389,129,5471,11056,-0.015367926233954077,-0.10557843504305503,Rep (McCain),Rep (Romney),3
north dakota,sheridan,550,227,0,777,637,161,10,808,1293,-0.4157014157014157,-0.5964912280701754,Rep (McCain),Rep (Romney),1
north dakota,sioux,215,1144,0,1359,223,900,15,1138,4121,0.6835908756438558,0.6028495102404274,Dem (Obama),Dem (Obama),1
north dakota,ransom,993,1369,0,2362,1008,1341,63,2412,5624,0.15918712955122777,0.1417624521072797,Dem (Obama),Dem (Obama),2
north dakota,mchenry,1371,980,0,2351,1651,924,78,2653,5400,-0.1663122075712463,-0.28233009708737866,Rep (McCain),Rep (Romney),2
north dakota,rolette,1042,3403,0,4445,1090,3351,87,4528,13766,0.5311586051743532,0.5091195676649404,Dem (Obama),Dem (Obama),3
north dakota,dunn,1078,526,0,1604,1494,493,15,2002,3477,-0.34413965087281795,-0.5037745344740815,Rep (McCain),Rep (Romney),1
north dakota,divide,629,461,0,1090,731,382,38,1151,2050,-0.15412844036697249,-0.31356693620844567,Rep (McCain),Rep (Romney),1
north dakota,grant,869,402,0,1271,1012,331,40,1383,2486,-0.36742722265932337,-0.5070737155621743,Rep (McCain),Rep (Romney),1
north dakota,mcintosh,914,579,0,1493,1028,456,26,1510,2917,-0.22438044206296048,-0.38544474393531,Rep (McCain),Rep (Romney),1
north dakota,towner,536,620,0,1156,619,511,34,1164,2289,0.0726643598615917,-0.09557522123893805,Dem (Obama),Rep (Romney),1
north dakota,williams,6273,2915,0,9188,7087,2288,225,9600,21194,-0.36547670875054417,-0.5118933333333333,Rep (McCain),Rep (Romney),5
north dakota,steele,404,612,0,1016,495,515,18,1028,1977,0.2047244094488189,0.019801980198019802,Dem (Obama),Dem (Obama),1
north dakota,pembina,1710,1486,0,3196,1893,1245,88,3226,7530,-0.07008760951188986,-0.20650095602294455,Rep (McCain),Rep (Romney),2
north dakota,eddy,548,582,0,1130,631,484,32,1147,2455,0.03008849557522124,-0.13183856502242153,Dem (Obama),Rep (Romney),1
north dakota,mountrail,1403,1476,0,2879,1960,1401,83,3444,7228,0.02535602639805488,-0.16631954775364474,Dem (Obama),Rep (Romney),2
north dakota,kidder,751,421,0,1172,870,393,47,1310,2521,-0.2815699658703072,-0.37767220902612825,Rep (McCain),Rep (Romney),1
north dakota,burke,639,285,0,924,766,230,19,1015,1948,-0.38311688311688313,-0.5381526104417671,Rep (McCain),Rep (Romney),1
north dakota,adams,785,434,0,1219,916,328,37,1281,2348,-0.28794093519278097,-0.47266881028938906,Rep (McCain),Rep (Romney),1
north dakota,morton,7853,5073,0,12926,8669,4467,374,13510,26712,-0.21507040074268916,-0.319884287454324,Rep (McCain),Rep (Romney),6
north dakota,logan,725,299,0,1024,799,221,22,1042,2001,-0.416015625,-0.5666666666666667,Rep (McCain),Rep (Romney),1
north dakota,renville,796,505,0,1301,850,398,24,1272,2442,-0.22367409684857803,-0.36217948717948717,Rep (McCain),Rep (Romney),1
north dakota,ward,15038,10125,0,25163,16176,8412,643,25231,59461,-0.19524698962762788,-0.31576378721327475,Rep (McCain),Rep (Romney),8
north dakota,nelson,797,904,0,1701,862,766,40,1668,3185,0.06290417401528513,-0.05896805896805897,Dem (Obama),Rep (Romney),1
north dakota,dickey,1517,1039,0,2556,1601,849,63,2513,5340,-0.18701095461658843,-0.3069387755102041,Rep (McCain),Rep (Romney),2
north dakota,mercer,2788,1472,0,4260,3132,1161,101,4394,8353,-0.3089201877934272,-0.4591194968553459,Rep (McCain),Rep (Romney),2
north dakota,slope,297,106,0,403,341,83,10,434,727,-0.4739454094292804,-0.6084905660377359,Rep (McCain),Rep (Romney),1
north dakota,griggs,682,597,0,1279,770,535,30,1335,2426,-0.06645817044566067,-0.18007662835249041,Rep (McCain),Rep (Romney),1
north dakota,cass,32515,37577,0,70092,36792,34632,1851,73275,144410,0.07221936882953832,-0.03024193548387097,Dem (Obama),Rep (Romney),9
north dakota,stark,7019,3794,0,10813,8509,2805,225,11539,23486,-0.29825210394895035,-0.5041541453066997,Rep (McCain),Rep (Romney),5
north dakota,foster,913,687,0,1600,1028,604,42,1674,3434,-0.14125,-0.25980392156862747,Rep (McCain),Rep (Romney),1
north dakota,sargent,774,1112,0,1886,876,1073,38,1987,3971,0.1792152704135737,0.10107747562852745,Dem (Obama),Dem (Obama),1
north dakota,hettinger,892,406,0,1298,998,313,40,1351,2506,-0.37442218798151,-0.5225019069412662,Rep (McCain),Rep (Romney),1
north dakota,bowman,1106,478,0,1584,1277,412,39,1728,3102,-0.39646464646464646,-0.5121373593842511,Rep (McCain),Rep (Romney),1
north dakota,stutsman,5484,4042,0,9526,5641,3561,229,9431,20984,-0.15137518370774722,-0.22603781786568136,Rep (McCain),Rep (Romney),5
north dakota,oliver,680,332,0,1012,693,281,36,1010,1808,-0.3438735177865613,-0.42299794661190965,Rep (McCain),Rep (Romney),1
north dakota,bottineau,2046,1384,0,3430,2246,1163,75,3484,6430,-0.19300291545189505,-0.31768847169257847,Rep (McCain),Rep (Romney),2
north dakota,benson,772,1566,0,2338,867,1232,49,2148,6662,0.339606501283148,0.17389232968080037,Dem (Obama),Dem (Obama),2
north dakota,mckenzie,1730,932,0,2662,2450,926,47,3423,6004,-0.2997746055597295,-0.4514218009478673,Rep (McCain),Rep (Romney),2
north dakota,traill,1839,2135,0,3974,1963,1784,94,3841,8190,0.07448414695520886,-0.04777155057379237,Dem (Obama),Rep (Romney),2
north dakota,mclean,2762,1858,0,4620,3130,1660,104,4894,8861,-0.19567099567099566,-0.3068893528183716,Rep (McCain),Rep (Romney),2
north dakota,goldenvalley,640,209,0,849,740,161,23,924,1539,-0.5076560659599529,-0.6426193118756937,Rep (McCain),Rep (Romney),1
north dakota,burleigh,25381,15524,0,40905,27811,14036,1029,42876,78776,-0.24097298618750765,-0.32917532917532916,Rep (McCain),Rep (Romney),8
north dakota,billings,375,114,0,489,472,89,16,577,897,-0.5337423312883436,-0.6827094474153298,Rep (McCain),Rep (Romney),1
north dakota,lamoure,1307,868,0,2175,1374,737,68,2179,4233,-0.20183908045977011,-0.30175272382756985,Rep (McCain),Rep (Romney),1
north dakota,cavalier,1125,930,0,2055,1192,818,44,2054,4046,-0.0948905109489051,-0.18606965174129353,Rep (McCain),Rep (Romney),1
north dakota,pierce,1300,792,0,2092,1462,656,44,2162,4364,-0.24282982791587,-0.380547686496695,Rep (McCain),Rep (Romney),1
north dakota,emmons,1226,545,0,1771,1430,383,49,1862,3617,-0.3845285149632976,-0.5774958632101489,Rep (McCain),Rep (Romney),1
ohio,preble,13340,6846,0,20186,13202,6005,412,19619,42502,-0.3217081145348261,-0.3747071380225959,Rep (McCain),Rep (Romney),7
ohio,huron,10001,9461,0,19462,12821,10673,583,24077,59932,-0.02774637755626349,-0.09142759853579638,Rep (McCain),Rep (Romney),8
ohio,shelby,15005,6777,0,21782,16700,6065,364,23129,49350,-0.37774309062528694,-0.46716450691851524,Rep (McCain),Rep (Romney),7
ohio,delaware,53670,35848,0,89518,58980,36131,1219,96330,166108,-0.19908845148461762,-0.24023509373258614,Rep (McCain),Rep (Romney),9
ohio,darke,17226,7456,0,24682,17745,6610,452,24807,52945,-0.3958350214731383,-0.4571956477109423,Rep (McCain),Rep (Romney),8
ohio,medina,31785,24614,0,56399,49464,37841,1544,88849,170137,-0.12714764446178123,-0.133130977607239,Rep (McCain),Rep (Romney),9
ohio,crawford,12050,8045,0,20095,11561,7207,424,19192,44294,-0.19930330928091566,-0.23199062233589088,Rep (McCain),Rep (Romney),7
ohio,clermont,60287,30124,0,90411,62527,29334,1531,93392,195312,-0.3336209089601929,-0.3613394149856849,Rep (McCain),Rep (Romney),10
ohio,hancock,21898,13357,0,35255,22077,12192,671,34940,74670,-0.24226350872216706,-0.288453120896437,Rep (McCain),Rep (Romney),8
ohio,marion,14840,12016,0,26856,13938,11933,562,26433,66530,-0.1051534107834376,-0.07749990336670404,Rep (McCain),Rep (Romney),8
ohio,greene,39252,27162,0,66414,48683,31028,1364,81075,159940,-0.18203993133977775,-0.22148762404185118,Rep (McCain),Rep (Romney),9
ohio,butler,91290,57521,0,148811,102226,59282,2512,164020,363465,-0.22692542889974532,-0.2658939495257201,Rep (McCain),Rep (Romney),10
ohio,richland,32590,24473,0,57063,33057,21785,1112,55954,125980,-0.14224628918914184,-0.20553590313992925,Rep (McCain),Rep (Romney),9
ohio,hocking,6201,6083,0,12284,6150,6010,282,12442,29338,-0.009605991533702377,-0.011513157894736841,Rep (McCain),Rep (Romney),6
ohio,pike,6005,5833,0,11838,5535,5490,208,11233,28674,-0.014529481331305964,-0.004081632653061225,Rep (McCain),Rep (Romney),6
ohio,columbiana,24891,21222,0,46113,24778,19351,949,45078,108609,-0.07956541539262248,-0.12298035305581363,Rep (McCain),Rep (Romney),9
ohio,noble,3387,2419,0,5806,3498,2082,175,5755,14634,-0.16672407853944196,-0.2537634408602151,Rep (McCain),Rep (Romney),4
ohio,licking,30545,19768,0,50313,43604,32264,1555,77423,163708,-0.2141991135491821,-0.14947013233510834,Rep (McCain),Rep (Romney),9
ohio,guernsey,8950,7369,0,16319,8811,7226,366,16403,40351,-0.09688093633188308,-0.09883394649872171,Rep (McCain),Rep (Romney),7
ohio,geauga,28314,20692,0,49006,30104,19295,726,50125,93604,-0.15553197567644778,-0.21881009737039211,Rep (McCain),Rep (Romney),9
ohio,champaign,10919,7161,0,18080,11852,7826,338,20016,40140,-0.20785398230088495,-0.20459396280109768,Rep (McCain),Rep (Romney),7
ohio,wood,28819,32956,0,61775,28997,31596,1374,61967,125295,0.06696883852691218,0.04289274338619973,Dem (Obama),Dem (Obama),9
ohio,meigs,5891,3990,0,9881,5782,3911,286,9979,23649,-0.19238943426778665,-0.1930258949757557,Rep (McCain),Rep (Romney),5
ohio,athens,9107,19258,0,28365,8118,17268,726,26112,64455,0.3578706151947823,0.36043488536988894,Dem (Obama),Dem (Obama),8
ohio,williams,9618,7892,0,17510,9863,7045,378,17286,38172,-0.09857224443175329,-0.16666666666666666,Rep (McCain),Rep (Romney),7
ohio,seneca,13588,12751,0,26339,13025,10962,646,24633,57091,-0.03177797182884696,-0.08600491933130446,Rep (McCain),Rep (Romney),8
ohio,mahoning,44339,76356,0,120695,41702,74298,1571,117571,241899,0.26527196652719665,0.281,Dem (Obama),Dem (Obama),10
ohio,vinton,2962,2405,0,5367,2798,2382,172,5352,13485,-0.10378237376560462,-0.08030888030888031,Rep (McCain),Rep (Romney),3
ohio,tuscarawas,19940,20957,0,40897,21420,17516,919,39855,92508,0.024867349683350855,-0.1002671049928087,Dem (Obama),Rep (Romney),9
ohio,morrow,9787,5960,0,15747,9662,5780,371,15813,34815,-0.24303041849241125,-0.2513923066960238,Rep (McCain),Rep (Romney),6
ohio,ross,16027,13636,0,29663,14582,13895,484,28961,77537,-0.08060546809156188,-0.024124732240053376,Rep (McCain),Rep (Romney),8
ohio,pickaway,13087,8229,0,21316,13713,9335,395,23443,55128,-0.22790392193657347,-0.18995140576188824,Rep (McCain),Rep (Romney),8
ohio,carroll,6952,6302,0,13254,7177,5396,392,12965,28988,-0.04904179870227856,-0.14165274795196056,Rep (McCain),Rep (Romney),6
ohio,adams,6725,4041,0,10766,6691,3857,239,10787,28578,-0.2493033624373026,-0.26867652635570727,Rep (McCain),Rep (Romney),6
ohio,logan,13440,7615,0,21055,13323,6789,423,20535,46006,-0.27665637615768224,-0.3248806682577566,Rep (McCain),Rep (Romney),7
ohio,belmont,15127,15986,0,31113,16418,13826,632,30876,70403,0.02760903802269148,-0.08570294934532469,Dem (Obama),Rep (Romney),8
ohio,henry,8091,6163,0,14254,8111,5513,313,13937,28546,-0.1352602778167532,-0.19069289489136818,Rep (McCain),Rep (Romney),6
ohio,trumbull,39319,62254,0,101573,37545,59446,1712,98703,212780,0.22579819440205567,0.22580445608355415,Dem (Obama),Dem (Obama),10
ohio,jackson,7837,5108,0,12945,7651,4965,300,12916,33165,-0.2108149864812669,-0.21290424857324033,Rep (McCain),Rep (Romney),6
ohio,washington,16638,12082,0,28720,16921,11333,544,28798,62066,-0.1586350974930362,-0.19777730586819564,Rep (McCain),Rep (Romney),8
ohio,muskingum,20174,17209,0,37383,18826,16327,801,35954,85951,-0.07931412674210203,-0.07108923847182318,Rep (McCain),Rep (Romney),8
ohio,erie,17080,22277,0,39357,16655,20969,638,38262,77454,0.13204766623472317,0.1146608547735488,Dem (Obama),Dem (Obama),8
ohio,defiance,9334,7394,0,16728,9935,7438,371,17744,39119,-0.11597321855571496,-0.1437287745351983,Rep (McCain),Rep (Romney),7
ohio,clinton,12037,6267,0,18304,11740,5534,374,17648,42416,-0.31523164335664333,-0.35926826444367255,Rep (McCain),Rep (Romney),7
ohio,paulding,5204,4043,0,9247,5248,3435,229,8912,19679,-0.12555423380555855,-0.20879880225728434,Rep (McCain),Rep (Romney),5
ohio,monroe,2973,3623,0,6596,3540,3007,196,6743,14751,0.09854457246816252,-0.08141133343516115,Dem (Obama),Rep (Romney),4
ohio,hardin,7553,4847,0,12400,7337,4487,323,12147,32104,-0.2182258064516129,-0.24103518267929636,Rep (McCain),Rep (Romney),6
ohio,miami,22217,10739,0,32956,33650,15731,900,50281,102315,-0.3482825585629324,-0.36287235981450355,Rep (McCain),Rep (Romney),9
ohio,mercer,14730,5636,0,20366,16207,4609,345,21161,40958,-0.4465285279387214,-0.5571675634127594,Rep (McCain),Rep (Romney),7
ohio,jefferson,11941,11269,0,23210,16729,14960,638,32327,70041,-0.02895303748384317,-0.05582378743412541,Rep (McCain),Rep (Romney),8
ohio,hamilton,187862,208802,0,396664,188653,208508,5411,402572,802194,0.052790270858963755,0.049992320494711216,Dem (Obama),Dem (Obama),10
ohio,fulton,11414,9627,0,21041,11521,8790,446,20757,42756,-0.08492942350648733,-0.13445916006105066,Rep (McCain),Rep (Romney),7
ohio,stark,63283,66712,0,129995,86958,86314,3348,176620,376346,0.026377937612985115,-0.0037166997552980285,Dem (Obama),Rep (Romney),10
ohio,highland,11390,6437,0,17827,11032,5772,357,17161,43648,-0.27783698883715713,-0.3130207093549155,Rep (McCain),Rep (Romney),7
ohio,cuyahoga,196369,441836,0,638205,184475,420953,6084,611512,1293825,0.38462092901183786,0.3905964045270453,Dem (Obama),Dem (Obama),10
ohio,warren,69741,32372,0,102113,74626,31907,1475,108008,207790,-0.36595732179056534,-0.400993119502877,Rep (McCain),Rep (Romney),10
ohio,ashland,14788,9027,0,23815,15225,8083,518,23826,53341,-0.24190636153684653,-0.30641839711686975,Rep (McCain),Rep (Romney),8
ohio,morgan,3387,2921,0,6308,3136,2772,134,6042,15113,-0.073874445149017115,-0.061611374407582936,Rep (McCain),Rep (Romney),4
ohio,putnam,12855,5169,0,18024,13563,4238,325,18126,34647,-0.4264314247669774,-0.5238469748890512,Rep (McCain),Rep (Romney),6
ohio,portage,26959,32160,0,59119,34465,38082,1482,74029,159943,0.08797510106733876,0.049857333866321144,Dem (Obama),Dem (Obama),9
ohio,ottawa,10417,11760,0,22177,10323,11214,399,21936,41553,0.06055823601028092,0.041370664437944,Dem (Obama),Dem (Obama),7
ohio,lucas,70865,134729,0,205594,68100,129229,3521,200850,444046,0.3106316332188683,0.3097821404861931,Dem (Obama),Dem (Obama),10
ohio,fayette,6931,4199,0,11130,6456,4075,146,10677,28913,-0.24546271338724168,-0.2260943879973412,Rep (McCain),Rep (Romney),6
ohio,auglaize,15938,6492,0,22430,16802,5643,393,22838,46023,-0.42113241194828355,-0.4971708621073736,Rep (McCain),Rep (Romney),7
ohio,wayne,28730,21144,0,49874,29450,18932,974,49356,114438,-0.15210330031679833,-0.2173948989293539,Rep (McCain),Rep (Romney),9
ohio,coshocton,8583,7580,0,16163,8312,6841,402,15555,37046,-0.06205531151395162,-0.09707648650432257,Rep (McCain),Rep (Romney),7
ohio,scioto,16472,14470,0,30942,15023,14432,568,30023,78988,-0.064701699954754055,-0.02006450517738924,Rep (McCain),Rep (Romney),8
ohio,madison,10178,6193,0,16371,10215,6700,325,17240,42844,-0.2434182395699713,-0.20780372450487733,Rep (McCain),Rep (Romney),7
ohio,sandusky,13935,15101,0,29036,13491,14035,666,28192,61284,0.04015704642512743,0.01976313303785512,Dem (Obama),Dem (Obama),8
ohio,knox,16207,10702,0,26909,16873,10154,591,27618,60201,-0.20457839384592516,-0.24860324860324862,Rep (McCain),Rep (Romney),8
ohio,fairfield,40708,28487,0,69195,40134,28831,1114,70079,143949,-0.17661680757280152,-0.16389472921046908,Rep (McCain),Rep (Romney),9
ohio,montgomery,119026,132375,0,251401,121188,128983,4095,254266,538461,0.05309843636262385,0.031158687457778878,Dem (Obama),Dem (Obama),10
ohio,franklin,192563,285499,0,478062,207941,325654,8156,541751,1141117,0.19440156297718705,0.22060364133846833,Dem (Obama),Dem (Obama),10
ohio,ashtabula,18464,24233,0,42697,17890,22964,927,41781,101867,0.13511487926552218,0.12419836490918881,Dem (Obama),Dem (Obama),9
ohio,wyandot,6190,4362,0,10552,6054,3962,238,10254,22665,-0.17323730098559514,-0.20886581469648563,Rep (McCain),Rep (Romney),5
ohio,perry,7585,7128,0,14713,7498,6857,318,14673,35843,-0.031060966492217765,-0.044653430860327414,Rep (McCain),Rep (Romney),6
ohio,holmes,7590,3074,0,10664,8563,2568,224,11355,42068,-0.4234808702175544,-0.5385859311831821,Rep (McCain),Rep (Romney),7
ohio,harrison,3717,3495,0,7212,3936,2895,168,6999,15867,-0.030782029950083195,-0.15239350021958717,Rep (McCain),Rep (Romney),4
ohio,gallia,8047,4616,0,12663,5912,3418,204,9534,30943,-0.27094685303640526,-0.2673097534833869,Rep (McCain),Rep (Romney),6
ohio,brown,11873,7280,0,19153,11671,6923,361,18955,44618,-0.23980577455228946,-0.25535118855544797,Rep (McCain),Rep (Romney),7
ohio,vanwert,8993,5046,0,14039,9433,3923,230,13586,29029,-0.28114538072512285,-0.41254866726564837,Rep (McCain),Rep (Romney),6
ohio,union,15049,8348,0,23397,15947,8546,454,24947,50708,-0.28640423985981106,-0.30216796635773485,Rep (McCain),Rep (Romney),7
ohio,summit,107937,151932,0,259869,108700,147146,3543,259389,543150,0.16929683802223428,0.15027008434761535,Dem (Obama),Dem (Obama),10
ohio,lorain,55031,77719,0,132750,58095,78112,2306,138513,299605,0.17090772128060264,0.14696014154925957,Dem (Obama),Dem (Obama),10
ohio,allen,26167,16575,0,42742,28802,16869,787,46458,106586,-0.22441626503205278,-0.2612817761818222,Rep (McCain),Rep (Romney),9
ohio,lawrence,15055,10956,0,26011,14371,10454,427,25252,62647,-0.15758717465687594,-0.15778449144008055,Rep (McCain),Rep (Romney),8
ohio,lake,54441,54786,0,109227,57150,55219,1895,114264,229418,0.0031585596967782692,-0.017184454787352383,Dem (Obama),Rep (Romney),10
ohio,clark,31821,29122,0,60943,31116,30022,998,62136,139374,-0.0442872848399324,-0.017893944846085905,Rep (McCain),Rep (Romney),9
oklahoma,woods,3043,870,0,3913,2725,670,0,3395,8656,-0.5553283925376948,-0.605301914580265,Rep (McCain),Rep (Romney),2
oklahoma,harper,1342,221,0,1563,1261,173,0,1434,3607,-0.7172104926423545,-0.7587168758716876,Rep (McCain),Rep (Romney),1
oklahoma,comanche,20127,14120,0,34247,17657,12517,0,30174,119902,-0.17540222501240985,-0.17034533041691521,Rep (McCain),Rep (Romney),9
oklahoma,cleveland,64730,39673,0,104403,59019,34701,0,93720,246831,-0.24000268191527063,-0.2594750320102433,Rep (McCain),Rep (Romney),10
oklahoma,osage,12150,7493,0,19643,11218,6695,0,17913,47192,-0.23708191213154814,-0.25249818567520793,Rep (McCain),Rep (Romney),7
oklahoma,ellis,1627,282,0,1909,1575,226,0,1801,4041,-0.7045573598742797,-0.7490283176013326,Rep (McCain),Rep (Romney),1
oklahoma,alfalfa,2023,411,0,2434,1539,278,0,1817,5621,-0.6622843056696796,-0.6940011007154651,Rep (McCain),Rep (Romney),2
oklahoma,craig,3858,2072,0,5930,3552,1746,0,5298,14951,-0.3011804384485666,-0.3408833522083805,Rep (McCain),Rep (Romney),4
oklahoma,atoka,3509,1370,0,4879,3534,1241,0,4775,14140,-0.4384095101455216,-0.48020942408376965,Rep (McCain),Rep (Romney),4
oklahoma,delaware,10274,5084,0,15358,10056,4176,0,14232,41017,-0.33793462690454484,-0.4131534569983137,Rep (McCain),Rep (Romney),7
oklahoma,choctaw,3729,1859,0,5588,3572,1494,0,5066,15190,-0.3346456692913386,-0.4101855507303593,Rep (McCain),Rep (Romney),4
oklahoma,beaver,2197,265,0,2462,2057,243,0,2300,5564,-0.784727863525589,-0.788695652173913,Rep (McCain),Rep (Romney),2
oklahoma,carter,13241,5603,0,18844,12213,4907,0,17120,46993,-0.4053279558480153,-0.4267523364485981,Rep (McCain),Rep (Romney),7
oklahoma,tulsa,158222,96106,0,254328,144908,82633,0,227541,589757,-0.2442357900034601,-0.27368693993609944,Rep (McCain),Rep (Romney),10
oklahoma,rogermills,1502,286,0,1788,1402,272,0,1674,3530,-0.680089485458613,-0.6750298685782556,Rep (McCain),Rep (Romney),1
oklahoma,woodward,6402,1348,0,7750,5936,1129,0,7065,19967,-0.6521290322580645,-0.6803963198867657,Rep (McCain),Rep (Romney),5
oklahoma,johnston,2707,1246,0,3953,2644,1134,0,3778,10816,-0.36959271439413105,-0.39968237162519854,Rep (McCain),Rep (Romney),3
oklahoma,grady,15187,5516,0,20703,14818,4780,0,19598,51545,-0.4671303675795778,-0.5121951219512195,Rep (McCain),Rep (Romney),7
oklahoma,canadian,36411,11422,0,47833,35615,10533,0,46148,109814,-0.5224217590366483,-0.5435121782092398,Rep (McCain),Rep (Romney),9
oklahoma,caddo,6401,3395,0,9796,5660,3151,0,8811,28951,-0.30685994283380974,-0.2847576892520713,Rep (McCain),Rep (Romney),6
oklahoma,noble,3881,1174,0,5055,3484,1142,0,4626,11509,-0.535509396636993,-0.5062689148292261,Rep (McCain),Rep (Romney),3
oklahoma,kiowa,2536,1226,0,3762,2309,1101,0,3410,9540,-0.34821903242955876,-0.35425219941348973,Rep (McCain),Rep (Romney),3
oklahoma,harmon,757,333,0,1090,659,264,0,923,2875,-0.3889908256880734,-0.4279523293607801,Rep (McCain),Rep (Romney),1
oklahoma,grant,1836,514,0,2350,1674,393,0,2067,4579,-0.5625531914893617,-0.6197387518142236,Rep (McCain),Rep (Romney),1
oklahoma,bryan,9295,4423,0,13718,9188,3533,0,12721,41195,-0.3551538125091121,-0.44454052354374657,Rep (McCain),Rep (Romney),7
oklahoma,mcintosh,4903,3318,0,8221,4498,2767,0,7265,20012,-0.19279892957061184,-0.23826565726083965,Rep (McCain),Rep (Romney),5
oklahoma,stephens,14392,4538,0,18930,12907,3939,0,16846,44454,-0.5205493924986794,-0.5323518936245993,Rep (McCain),Rep (Romney),7
oklahoma,mayes,10231,5749,0,15980,9634,4822,0,14456,40807,-0.2804755944931164,-0.33287216380741563,Rep (McCain),Rep (Romney),7
oklahoma,greer,1548,566,0,2114,1344,488,0,1832,6182,-0.4645222327341533,-0.4672489082969432,Rep (McCain),Rep (Romney),2
oklahoma,marshall,3729,1642,0,5371,3744,1396,0,5140,15465,-0.38856823682740643,-0.45680933852140077,Rep (McCain),Rep (Romney),4
oklahoma,pittsburg,11739,5454,0,17193,10785,4813,0,15598,45417,-0.36555574943290875,-0.3828695986664957,Rep (McCain),Rep (Romney),7
oklahoma,texas,5332,923,0,6255,4908,854,0,5762,19826,-0.7048760991207035,-0.7035751475182228,Rep (McCain),Rep (Romney),5
oklahoma,logan,12555,5716,0,18271,12297,4686,0,16983,39777,-0.3743090142849324,-0.4481540363893305,Rep (McCain),Rep (Romney),7
oklahoma,blaine,3100,1011,0,4111,2824,991,0,3815,11972,-0.5081488688883483,-0.48047182175622544,Rep (McCain),Rep (Romney),3
oklahoma,rogers,27732,10770,0,38502,27531,9146,0,36677,85044,-0.44054854293283463,-0.5012678245221801,Rep (McCain),Rep (Romney),8
oklahoma,kingfisher,5372,1009,0,6381,4510,844,0,5354,14776,-0.6837486287415766,-0.6847217033993276,Rep (McCain),Rep (Romney),4
oklahoma,cherokee,9182,7193,0,16375,8151,6137,0,14288,46182,-0.12146564885496183,-0.14095744680851063,Rep (McCain),Rep (Romney),7
oklahoma,okfuskee,2642,1470,0,4112,2328,1251,0,3579,12036,-0.2850194552529183,-0.30092204526404026,Rep (McCain),Rep (Romney),3
oklahoma,jackson,6716,2263,0,8979,5962,1953,0,7915,26386,-0.4959349593495935,-0.5065066329753632,Rep (McCain),Rep (Romney),6
oklahoma,beckham,5769,1625,0,7394,5496,1413,0,6909,21817,-0.5604544225047335,-0.5909683022145028,Rep (McCain),Rep (Romney),5
oklahoma,washington,16457,6308,0,22765,15667,5532,0,21199,50339,-0.4458159455304195,-0.4780885890843908,Rep (McCain),Rep (Romney),7
oklahoma,pushmataha,3208,1265,0,4473,3087,1043,0,4130,11500,-0.43438408227140624,-0.49491525423728816,Rep (McCain),Rep (Romney),3
oklahoma,pawnee,4533,2063,0,6596,4228,1813,0,6041,16564,-0.3744693753790176,-0.39976825028968715,Rep (McCain),Rep (Romney),4
oklahoma,tillman,2195,1042,0,3237,1813,906,0,2719,8154,-0.35619400679641644,-0.33357852151526296,Rep (McCain),Rep (Romney),2
oklahoma,muskogee,15276,11286,0,26562,13392,9943,0,23335,70383,-0.15021459227467812,-0.14780372830512106,Rep (McCain),Rep (Romney),8
oklahoma,jefferson,1649,805,0,2454,1632,602,0,2234,6435,-0.3439282803585982,-0.4610564010743062,Rep (McCain),Rep (Romney),2
oklahoma,mcclain,11184,3550,0,14734,11108,3191,0,14299,33107,-0.5181213519750237,-0.5536750821735785,Rep (McCain),Rep (Romney),6
oklahoma,major,2955,515,0,3470,2700,446,0,3146,7487,-0.7031700288184438,-0.7164653528289892,Rep (McCain),Rep (Romney),2
oklahoma,nowata,3029,1411,0,4440,2832,1244,0,4076,10674,-0.3644144144144144,-0.38959764474975467,Rep (McCain),Rep (Romney),3
oklahoma,leflore,11603,5136,0,16739,11172,4658,0,15830,49822,-0.3863432702073003,-0.4114971572962729,Rep (McCain),Rep (Romney),7
oklahoma,murray,3746,1592,0,5338,3606,1540,0,5146,13193,-0.4035219183214687,-0.4014768752429071,Rep (McCain),Rep (Romney),3
oklahoma,garfield,17066,5545,0,22611,15176,4732,0,19908,59093,-0.5095307593649109,-0.5246132208157525,Rep (McCain),Rep (Romney),8
oklahoma,sequoyah,9465,4454,0,13919,9573,4193,0,13766,41855,-0.3600114950786694,-0.3908179572860671,Rep (McCain),Rep (Romney),7
oklahoma,payne,18435,10601,0,29036,16467,9193,0,25660,75687,-0.2698030031684805,-0.28347622759158225,Rep (McCain),Rep (Romney),8
oklahoma,okmulgee,8724,6187,0,14911,7712,5416,0,13128,39664,-0.1701428475622024,-0.1748933577087142,Rep (McCain),Rep (Romney),7
oklahoma,garvin,7708,3028,0,10736,6922,2556,0,9478,27462,-0.43591654247391953,-0.460645705845115,Rep (McCain),Rep (Romney),6
oklahoma,cimarron,1119,152,0,1271,1082,115,0,1197,2503,-0.7608182533438238,-0.8078529657477026,Rep (McCain),Rep (Romney),1
oklahoma,ottawa,6904,4266,0,11170,6465,3508,0,9973,32193,-0.2361683079677708,-0.2965005514890204,Rep (McCain),Rep (Romney),6
oklahoma,mccurtain,7744,2792,0,10536,7633,2440,0,10073,33130,-0.47000759301442674,-0.5155365829445051,Rep (McCain),Rep (Romney),6
oklahoma,kay,13229,5462,0,18691,11498,4624,0,16122,46473,-0.4155475897490771,-0.4263738990199727,Rep (McCain),Rep (Romney),7
oklahoma,coal,1609,570,0,2179,1709,648,0,2357,5801,-0.4768242312987609,-0.450148493848112,Rep (McCain),Rep (Romney),2
oklahoma,seminole,5599,2977,0,8576,4852,2597,0,7449,25224,-0.30573694029850745,-0.3027251980131561,Rep (McCain),Rep (Romney),5
oklahoma,oklahoma,163099,116133,0,279232,149525,106812,0,256337,704023,-0.1681970547788219,-0.16662830570694048,Rep (McCain),Rep (Romney),10
oklahoma,latimer,2857,1313,0,4170,2620,1169,0,3789,11015,-0.37026378896882495,-0.38295064660860384,Rep (McCain),Rep (Romney),3
oklahoma,hughes,3132,1705,0,4837,2836,1370,0,4206,13606,-0.2950175728757494,-0.3485496909177366,Rep (McCain),Rep (Romney),3
oklahoma,pottawatomie,17728,7906,0,25634,16240,7182,0,23422,68751,-0.38316298665834436,-0.38673042438732813,Rep (McCain),Rep (Romney),8
oklahoma,pontotoc,9749,4511,0,14260,8921,3934,0,12855,36644,-0.3673211781206171,-0.3879424348502528,Rep (McCain),Rep (Romney),7
oklahoma,love,2589,1257,0,3846,2436,1034,0,3470,9306,-0.3463338533541342,-0.4040345821325648,Rep (McCain),Rep (Romney),3
oklahoma,washita,3716,1050,0,4766,3482,821,0,4303,11571,-0.5593789341166596,-0.6184057634208692,Rep (McCain),Rep (Romney),3
oklahoma,dewey,1857,346,0,2203,1769,301,0,2070,4720,-0.6858828869723105,-0.7091787439613526,Rep (McCain),Rep (Romney),1
oklahoma,custer,7842,2660,0,10502,7442,2358,0,9800,26824,-0.49342982289087794,-0.5187755102040816,Rep (McCain),Rep (Romney),6
oklahoma,creek,20181,8318,0,28499,18964,7114,0,26078,68914,-0.4162602196568301,-0.45440601273103765,Rep (McCain),Rep (Romney),8
oklahoma,wagoner,21426,8805,0,30231,20848,7773,0,28621,70232,-0.4174853627071549,-0.45683239579329865,Rep (McCain),Rep (Romney),8
oklahoma,lincoln,10468,3503,0,13971,9542,3265,0,12807,33823,-0.49853267482642616,-0.4901225892090263,Rep (McCain),Rep (Romney),6
oklahoma,cotton,1793,690,0,2483,1796,657,0,2453,6230,-0.44422070076520337,-0.46432939258051364,Rep (McCain),Rep (Romney),2
oklahoma,adair,4636,2049,0,6685,4362,2110,0,6472,22424,-0.3869857890800299,-0.3479604449938195,Rep (McCain),Rep (Romney),5
oklahoma,haskell,3206,1474,0,4680,3069,1175,0,4244,12577,-0.3700854700854701,-0.4462770970782281,Rep (McCain),Rep (Romney),3
oregon,wallowa,2832,1490,0,4322,2796,1252,104,4152,6919,-0.3105043961129107,-0.3814229249011858,Rep (McCain),Rep (Romney),2
oregon,douglas,28635,19153,0,47788,30588,17032,1442,49062,107209,-0.19841801289026534,-0.2846703065938681,Rep (McCain),Rep (Romney),9
oregon,baker,5643,2795,0,8438,5692,2364,295,8351,16150,-0.3375207395117326,-0.4131082423038729,Rep (McCain),Rep (Romney),4
oregon,multnomah,50173,164597,0,214770,73306,265938,11708,350952,712036,0.5327745960795269,0.5678272865548101,Dem (Obama),Dem (Obama),10
oregon,gilliam,642,429,0,1071,637,371,36,1044,1731,-0.19887955182072828,-0.2638888888888889,Rep (McCain),Rep (Romney),1
oregon,polk,17272,17046,0,34318,17377,15761,858,33996,73745,-0.006585465353458826,-0.0487657673969461,Rep (McCain),Rep (Romney),8
oregon,marion,42193,44853,0,87046,58435,54337,2747,115519,309894,0.030558555246651197,-0.036338807505409146,Dem (Obama),Rep (Romney),10
oregon,hoodriver,3240,6229,0,9469,3400,5977,285,9662,21706,0.3156616326961664,0.2748213714407593,Dem (Obama),Dem (Obama),5
oregon,tillamook,5732,7018,0,12750,5670,6249,427,12346,25200,0.10086274509803922,0.0485779008306066,Dem (Obama),Dem (Obama),5
oregon,coos,12475,12413,0,24888,14398,12628,900,27926,63319,-0.0024911603985856637,-0.06549248871457115,Rep (McCain),Rep (Romney),8
oregon,grant,2670,980,0,3650,2848,834,96,3778,7349,-0.46301369863013697,-0.5469853340575774,Rep (McCain),Rep (Romney),2
oregon,columbia,10351,13253,0,23604,10645,11843,810,23298,49006,0.12294526351465854,0.05327285663464959,Dem (Obama),Dem (Obama),7
oregon,yamhill,21068,20494,0,41562,21711,18906,1133,41750,96930,-0.013810692459458158,-0.06905975330526627,Rep (McCain),Rep (Romney),9
oregon,crook,6348,3623,0,9971,6769,3081,259,10109,21515,-0.27329254839033196,-0.37441624365482234,Rep (McCain),Rep (Romney),5
oregon,clatsop,4902,7311,0,12213,7101,9616,489,17206,36858,0.1972488332105134,0.1504456541245439,Dem (Obama),Dem (Obama),7
oregon,curry,6626,5216,0,11842,6577,4611,341,11529,22411,-0.11906772504644486,-0.17572398998927422,Rep (McCain),Rep (Romney),5
oregon,morrow,2501,1398,0,3899,2524,1189,125,3838,11112,-0.28289304949987176,-0.3595475356854296,Rep (McCain),Rep (Romney),3
oregon,josephine,22124,16697,0,38821,23636,14929,1114,39679,82172,-0.1397954715231447,-0.22577466614806171,Rep (McCain),Rep (Romney),8
oregon,jackson,29925,34091,0,64016,46974,42341,2640,91955,200587,0.06507748062984255,-0.05187258579186027,Dem (Obama),Rep (Romney),10
oregon,washington,55956,98249,0,154205,86551,124431,5491,216473,516665,0.27426477740669886,0.17954138267719522,Dem (Obama),Dem (Obama),10
oregon,sherman,632,382,0,1014,677,317,25,1019,1819,-0.2465483234714004,-0.36217303822937624,Rep (McCain),Rep (Romney),1
oregon,wheeler,497,276,0,773,542,262,37,841,1443,-0.2858990944372574,-0.3482587064676617,Rep (McCain),Rep (Romney),1
oregon,jefferson,4360,3648,0,8008,4576,3238,164,7978,21652,-0.08891108891108891,-0.17123112362426415,Rep (McCain),Rep (Romney),5
oregon,benton,8718,20345,0,29063,14922,27662,1678,44262,84158,0.4000619344183326,0.2991733984595153,Dem (Obama),Dem (Obama),8
oregon,lane,24765,43987,0,68752,60979,99891,5306,166176,347156,0.27958459390272283,0.24188475166283335,Dem (Obama),Dem (Obama),10
oregon,umatilla,15126,9400,0,24526,15425,8499,699,24623,74804,-0.2334665253200685,-0.2895000835980605,Rep (McCain),Rep (Romney),8
oregon,klamath,18682,9015,0,27697,18654,8140,736,27530,66520,-0.34902697043001046,-0.39240128386952305,Rep (McCain),Rep (Romney),8
oregon,wasco,4900,5649,0,10549,5152,5066,332,10550,24695,0.0710019907100199,-0.008416519866901546,Dem (Obama),Rep (Romney),5
oregon,harney,2592,946,0,3538,2599,829,107,3535,7364,-0.4652345958168457,-0.5163360560093349,Rep (McCain),Rep (Romney),2
oregon,clackamas,32894,49989,0,82883,87647,94159,4006,185812,370479,0.20625459985763064,0.0358183998327888,Dem (Obama),Dem (Obama),10
oregon,linn,24191,19578,0,43769,28482,19893,1612,49987,114315,-0.10539422879206745,-0.17755038759689923,Rep (McCain),Rep (Romney),9
oregon,deschutes,38918,38612,0,77530,40670,34985,1786,77441,154568,-0.003946859280278602,-0.07514374463022933,Rep (McCain),Rep (Romney),9
oregon,malheur,7099,2922,0,10021,6751,2701,259,9711,31326,-0.41682466819678676,-0.428480744815912,Rep (McCain),Rep (Romney),6
oregon,union,7563,4612,0,12175,7608,3943,354,11905,25373,-0.24238193018480492,-0.31728854644619514,Rep (McCain),Rep (Romney),5
oregon,lincoln,8649,13991,0,22640,8623,13277,712,22612,45857,0.2359540636042403,0.21251141552511416,Dem (Obama),Dem (Obama),7
oregon,lake,2631,954,0,3585,2801,769,106,3676,7882,-0.46778242677824267,-0.569187675070028,Rep (McCain),Rep (Romney),2
pennsylvania,luzerne,60512,71903,0,132415,57969,63974,1798,123741,319120,0.08602499716799457,0.04924431906710512,Dem (Obama),Dem (Obama),10
pennsylvania,clarion,10126,6415,0,16541,10228,4731,268,15227,40290,-0.22435161114805635,-0.3674710876395481,Rep (McCain),Rep (Romney),7
pennsylvania,delaware,109322,169030,0,278352,105270,164805,2778,272853,556468,0.21450537448985457,0.22043876700916412,Dem (Obama),Dem (Obama),10
pennsylvania,carbon,12646,13235,0,25881,12710,11040,482,24232,64563,0.02275800780495344,-0.0703157894736842,Dem (Obama),Rep (Romney),8
pennsylvania,beaver,42358,39738,0,82096,42118,36833,1064,80015,171569,-0.03191385694796336,-0.06694025408164558,Rep (McCain),Rep (Romney),9
pennsylvania,crawford,19265,15684,0,34949,19497,13024,568,33089,89153,-0.10246358980228333,-0.19904061990713692,Rep (McCain),Rep (Romney),8
pennsylvania,montour,4555,3347,0,7902,4636,3026,125,7787,18152,-0.15287269045811186,-0.21012790394152964,Rep (McCain),Rep (Romney),4
pennsylvania,lackawanna,39198,67112,0,106310,34730,61309,1077,97116,213731,0.2625717242028031,0.27675215277127,Dem (Obama),Dem (Obama),10
pennsylvania,allegheny,269819,368453,0,638272,259304,348151,7216,614671,1223066,0.15453286373207661,0.1462610399124215,Dem (Obama),Dem (Obama),10
pennsylvania,indiana,19617,16964,0,36581,21187,14403,590,36180,88745,-0.0725239878625516,-0.19061534138803035,Rep (McCain),Rep (Romney),8
pennsylvania,greene,7451,7365,0,14816,7985,5564,177,13726,39003,-0.005804535637149028,-0.1786847737840431,Rep (McCain),Rep (Romney),7
pennsylvania,butler,52294,29882,0,82176,59416,28385,1123,88924,182554,-0.27273169781931467,-0.3534242206808578,Rep (McCain),Rep (Romney),9
pennsylvania,york,107367,81748,0,189115,111576,72126,2692,186394,428175,-0.13546783703037835,-0.21474997550380506,Rep (McCain),Rep (Romney),10
pennsylvania,pike,12456,11448,0,23904,12713,10170,281,23164,56993,-0.04216867469879518,-0.11113053358388324,Rep (McCain),Rep (Romney),8
pennsylvania,lebanon,32325,22004,0,54329,34010,18975,786,53771,131341,-0.18997220637228737,-0.28375955459092195,Rep (McCain),Rep (Romney),9
pennsylvania,cameron,1239,802,0,2041,1264,677,26,1967,5197,-0.21411073003429693,-0.3024214322514168,Rep (McCain),Rep (Romney),1
pennsylvania,dauphin,57964,69352,0,127316,56838,64209,1578,122625,264823,0.08944673096861352,0.06089370244615728,Dem (Obama),Dem (Obama),10
pennsylvania,columbia,13704,12597,0,26301,13445,10424,436,24305,66642,-0.0420896543857648,-0.12656583853533873,Rep (McCain),Rep (Romney),8
pennsylvania,centre,31971,39652,0,71623,33697,33677,1427,68801,151411,0.10724208703907963,-2.9685041707483596e-4,Dem (Obama),Rep (Romney),9
pennsylvania,blair,30812,18798,0,49610,31500,15516,615,47631,127071,-0.24216891755694417,-0.33996937212863704,Rep (McCain),Rep (Romney),9
pennsylvania,bedford,15928,6001,0,21929,16509,4730,205,21444,49882,-0.4526882210771125,-0.5545929657705165,Rep (McCain),Rep (Romney),7
pennsylvania,snyder,9895,5375,0,15270,10050,4672,240,14962,39400,-0.2960052390307793,-0.3653036272245619,Rep (McCain),Rep (Romney),7
pennsylvania,forest,1366,1014,0,2380,1381,894,33,2308,7585,-0.14789915966386555,-0.21406593406593408,Rep (McCain),Rep (Romney),2
pennsylvania,chester,112266,135150,0,247416,123280,122232,2783,248295,490571,0.09249199728392667,-0.004268630453908567,Dem (Obama),Rep (Romney),10
pennsylvania,berks,75868,91803,0,167671,80857,79895,2501,163253,407310,0.0950373051988716,-0.005984373444809396,Dem (Obama),Rep (Romney),10
pennsylvania,adams,26134,17475,0,43609,26490,14893,590,41973,100839,-0.1985599302896191,-0.28023584563709736,Rep (McCain),Rep (Romney),9
pennsylvania,mckean,8835,6186,0,15021,9494,5260,260,15014,43853,-0.1763531056520871,-0.2869730242646062,Rep (McCain),Rep (Romney),7
pennsylvania,washington,48753,44286,0,93039,50455,38503,1120,90078,206987,-0.0480121239480218,-0.13435553856876278,Rep (McCain),Rep (Romney),10
pennsylvania,potter,5073,2277,0,7350,5199,1892,114,7205,17583,-0.38040816326530613,-0.46636581582287406,Rep (McCain),Rep (Romney),4
pennsylvania,erie,49284,74206,0,123490,46102,65136,1494,112732,279234,0.2018139120576565,0.17111059170427373,Dem (Obama),Dem (Obama),10
pennsylvania,clinton,7126,6799,0,13925,6941,5503,219,12663,38970,-0.02348294434470377,-0.11555769848923175,Rep (McCain),Rep (Romney),7
pennsylvania,armstrong,17715,10729,0,28444,19231,8694,397,28322,69489,-0.2456054000843763,-0.37733213965980306,Rep (McCain),Rep (Romney),8
pennsylvania,monroe,25892,36655,0,62547,25100,33431,781,59312,168080,0.17207859689513486,0.14233483111513556,Dem (Obama),Dem (Obama),9
pennsylvania,northumberland,18012,13555,0,31567,18516,12392,604,31512,94099,-0.1411917508790826,-0.19813640481428757,Rep (McCain),Rep (Romney),9
pennsylvania,cambria,29981,30697,0,60678,33464,23181,1073,57718,144741,0.011799993407824913,-0.18153411598552388,Dem (Obama),Rep (Romney),9
pennsylvania,wyoming,6494,5631,0,12125,6189,4812,213,11214,28262,-0.07117525773195876,-0.12517043905099537,Rep (McCain),Rep (Romney),6
pennsylvania,mercer,24321,24319,0,48640,24304,23082,679,48065,117296,-4.111842105263158e-5,-0.025788207487443548,Rep (McCain),Rep (Romney),9
pennsylvania,jefferson,11248,6132,0,17380,12288,4535,249,17072,45244,-0.29436133486766397,-0.4608571598406943,Rep (McCain),Rep (Romney),7
pennsylvania,venango,12817,8708,0,21525,12928,7469,378,20775,55320,-0.19089430894308942,-0.2676373976565181,Rep (McCain),Rep (Romney),8
pennsylvania,lycoming,30215,18335,0,48550,30490,15104,620,46214,116376,-0.2446961894953656,-0.3374566828968724,Rep (McCain),Rep (Romney),9
pennsylvania,fulton,4612,1562,0,6174,4780,1297,71,6148,14839,-0.49400712666018787,-0.5731446437386869,Rep (McCain),Rep (Romney),4
pennsylvania,elk,6252,6910,0,13162,7099,5144,182,12425,32480,0.04999240237046042,-0.1596830842113861,Dem (Obama),Rep (Romney),6
pennsylvania,warren,9824,8669,0,18493,9415,6768,279,16462,41877,-0.0624560644568215,-0.16356670580238522,Rep (McCain),Rep (Romney),7
pennsylvania,philadelphia,112719,571635,0,684354,91840,557024,4734,653598,1504950,0.670582768567145,0.7169206490111949,Dem (Obama),Dem (Obama),10
pennsylvania,mifflin,10904,5364,0,16268,11893,4259,159,16311,46583,-0.34054585689697564,-0.47263496780584446,Rep (McCain),Rep (Romney),7
pennsylvania,cumberland,59693,45355,0,105048,64365,43983,1616,109964,231336,-0.13648998553042418,-0.1881160704396943,Rep (McCain),Rep (Romney),10
pennsylvania,susquehanna,10551,8314,0,18865,10735,6891,304,17930,43343,-0.1185793798038696,-0.21808691705435151,Rep (McCain),Rep (Romney),7
pennsylvania,huntingdon,12265,6989,0,19254,11953,5383,251,17587,45830,-0.2740209826529552,-0.3789801568989386,Rep (McCain),Rep (Romney),7
pennsylvania,westmoreland,96786,69004,0,165790,103429,63380,1900,168709,365841,-0.16757343627480548,-0.24008896402472288,Rep (McCain),Rep (Romney),10
pennsylvania,somerset,20925,12437,0,33362,23935,9420,520,33875,78219,-0.2544211977699179,-0.43516714135811724,Rep (McCain),Rep (Romney),8
pennsylvania,fayette,25669,25509,0,51178,25845,21841,510,48196,138807,-0.003126343350658486,-0.08396594388290064,Rep (McCain),Rep (Romney),9
pennsylvania,bucks,149860,178345,0,328205,155876,159598,3933,319407,622859,0.08679026827744854,0.011798119654868548,Dem (Obama),Dem (Obama),10
pennsylvania,wayne,12618,9824,0,22442,12531,8138,297,20966,52302,-0.12449870778005526,-0.21254051961875273,Rep (McCain),Rep (Romney),8
pennsylvania,sullivan,1840,1228,0,3068,1859,1028,47,2934,6467,-0.19947848761408082,-0.28784205057152756,Rep (McCain),Rep (Romney),2
pennsylvania,schuylkill,33682,28187,0,61869,32156,24453,896,57505,148288,-0.08881669333591945,-0.13607376918864492,Rep (McCain),Rep (Romney),9
pennsylvania,northampton,58352,74956,0,133308,59242,65014,1627,125883,294536,0.12455366519638732,0.046452485191861966,Dem (Obama),Dem (Obama),10
pennsylvania,juniata,6463,3055,0,9518,6821,2533,126,9480,24385,-0.35805841563353646,-0.45841351293564253,Rep (McCain),Rep (Romney),5
pennsylvania,montgomery,163030,249493,0,412523,169903,227561,4323,401787,790497,0.20959558618549753,0.14506471026306786,Dem (Obama),Dem (Obama),10
pennsylvania,franklin,41711,21052,0,62763,43072,18910,820,62802,146558,-0.32915889935152876,-0.3898228517956826,Rep (McCain),Rep (Romney),9
pennsylvania,clearfield,18656,14549,0,33205,20303,11093,498,31894,82131,-0.12368619183857853,-0.2933494712702255,Rep (McCain),Rep (Romney),8
pennsylvania,tioga,10542,6012,0,16554,10599,5053,291,15943,41631,-0.27364987314244293,-0.35433171479683107,Rep (McCain),Rep (Romney),7
pennsylvania,perry,13032,6384,0,19416,12511,5430,299,18240,45599,-0.34239802224969096,-0.39468257064823586,Rep (McCain),Rep (Romney),7
pennsylvania,union,9720,7207,0,16927,9863,6063,261,16187,44866,-0.14846103857742068,-0.23860354137887732,Rep (McCain),Rep (Romney),7
pennsylvania,lehigh,62668,86226,0,148894,66091,77029,1802,144922,343946,0.15821994170349377,0.07642537730575741,Dem (Obama),Dem (Obama),10
pennsylvania,lancaster,124475,97290,0,221765,129364,87108,3205,219677,511250,-0.1225847180574031,-0.19520307476255588,Rep (McCain),Rep (Romney),10
pennsylvania,bradford,14911,10202,0,25113,13827,8291,383,22501,62415,-0.18751244375423087,-0.25029387828917626,Rep (McCain),Rep (Romney),8
pennsylvania,lawrence,20135,18187,0,38322,20915,17427,474,38816,91682,-0.05083242001983195,-0.09097073705075374,Rep (McCain),Rep (Romney),9
rhode island,providence,77308,159653,0,236961,74344,156022,3726,234092,628413,0.347504441659176,0.3545575301910872,Dem (Obama),Dem (Obama),10
rhode island,bristol,8175,14256,0,22431,9216,14943,404,24563,50501,0.2710980339708439,0.23705451384577175,Dem (Obama),Dem (Obama),7
rhode island,washington,24135,36360,0,60495,24666,34904,1363,60933,126987,0.20208281676171586,0.17186503273459794,Dem (Obama),Dem (Obama),9
rhode island,newport,14538,23550,0,38088,16343,23507,695,40545,83253,0.2366099558916194,0.1797741530740276,Dem (Obama),Dem (Obama),8
rhode island,kent,32278,45932,0,78210,30786,44966,1495,77247,167235,0.17458125559391383,0.18718977716759955,Dem (Obama),Dem (Obama),9
south carolina,lee,3073,5958,0,9031,2829,5972,97,8898,19615,0.3194552098327981,0.3571185092603113,Dem (Obama),Dem (Obama),5
south carolina,chesterfield,8323,7840,0,16163,8488,7942,146,16576,46087,-0.02988306626245128,-0.0332318928788801,Rep (McCain),Rep (Romney),7
south carolina,hampton,3438,5811,0,9249,3310,5814,60,9184,21173,0.25656827765163803,0.2744410346339325,Dem (Obama),Dem (Obama),5
south carolina,barnwell,4769,4926,0,9695,4655,5182,76,9913,22748,0.016193914388860236,0.05357324387516519,Dem (Obama),Dem (Obama),5
south carolina,marion,5410,9575,0,14985,5114,9518,134,14766,33568,0.2779446112779446,0.30098414434117005,Dem (Obama),Dem (Obama),6
south carolina,anderson,48389,23807,0,72196,48493,22315,1093,71901,183691,-0.34048977782702644,-0.36970398824991524,Rep (McCain),Rep (Romney),9
south carolina,york,53842,37437,0,91279,59149,38757,1522,99428,214916,-0.17972370424741727,-0.20828141278369047,Rep (McCain),Rep (Romney),10
south carolina,richland,57234,104029,0,161263,46725,94350,1941,143016,372597,0.2901781561796568,0.33758639021796916,Dem (Obama),Dem (Obama),10
south carolina,clarendon,6211,8347,0,14558,6890,8967,128,15985,34621,0.14672345102349224,0.13098316201046856,Dem (Obama),Dem (Obama),6
south carolina,dorchester,29785,21691,0,51476,32469,23390,876,56735,129618,-0.15723832465615045,-0.16253423799208722,Rep (McCain),Rep (Romney),9
south carolina,calhoun,3691,3964,0,7655,3705,4043,82,7830,15212,0.0356629653821032,0.0436241610738255,Dem (Obama),Dem (Obama),4
south carolina,edgefield,6332,5072,0,11404,6511,4965,107,11583,26680,-0.11048754822869168,-0.1347159288950854,Rep (McCain),Rep (Romney),6
south carolina,chester,6278,7405,0,13683,6336,7839,149,14324,33246,0.0823649784404005,0.10603174603174603,Dem (Obama),Dem (Obama),6
south carolina,pickens,32453,11640,0,44093,33385,11122,915,45422,117823,-0.47202503798788925,-0.5002134495697306,Rep (McCain),Rep (Romney),9
south carolina,mccormick,2436,2747,0,5183,2460,2637,40,5137,10203,0.06000385876905267,0.034726309593878756,Dem (Obama),Dem (Obama),3
south carolina,marlboro,3948,6699,0,10647,4010,7554,93,11657,29112,0.2583826429980276,0.30646835005188516,Dem (Obama),Dem (Obama),6
south carolina,charleston,62278,75955,0,138233,77248,81027,2579,160854,342434,0.0989416420102291,0.02387616490285895,Dem (Obama),Dem (Obama),10
south carolina,abbeville,6224,4586,0,10810,5923,4507,147,10577,25643,-0.1515263644773358,-0.1357622243528284,Rep (McCain),Rep (Romney),5
south carolina,cherokee,13266,7191,0,20457,13306,7219,228,20753,54832,-0.29696436427628686,-0.2965651644336175,Rep (McCain),Rep (Romney),8
south carolina,allendale,940,3017,0,3957,894,3335,28,4257,10688,0.524892595400556,0.5772050130054386,Dem (Obama),Dem (Obama),3
south carolina,oconee,21157,9475,0,30632,21573,8537,503,30613,73035,-0.38136589187777487,-0.4329458651610761,Rep (McCain),Rep (Romney),8
south carolina,greenville,115822,70618,0,186440,120514,67378,3390,191282,436437,-0.24245869984981763,-0.2828007578821876,Rep (McCain),Rep (Romney),10
south carolina,greenwood,16804,12219,0,29023,16290,11884,351,28525,68890,-0.15797815525617614,-0.15638531979839568,Rep (McCain),Rep (Romney),8
south carolina,dillon,5873,7406,0,13279,5477,7623,86,13186,31666,0.11544544016868741,0.16381679389312978,Dem (Obama),Dem (Obama),6
south carolina,williamsburg,4989,11257,0,16246,4819,11318,145,16282,34994,0.38581804751938936,0.40273904691082607,Dem (Obama),Dem (Obama),6
south carolina,sumter,15945,22594,0,38539,19266,27550,445,47261,106601,0.17252653156542722,0.17694805194805194,Dem (Obama),Dem (Obama),9
south carolina,jasper,3363,5267,0,8630,4169,5727,95,9991,23634,0.22062572421784474,0.1574373484236055,Dem (Obama),Dem (Obama),5
south carolina,berkeley,36097,27657,0,63754,35764,24239,1108,61111,169878,-0.13238385042507136,-0.192073729646851,Rep (McCain),Rep (Romney),9
south carolina,laurens,15314,10565,0,25879,14726,10297,350,25373,67026,-0.1835078635186831,-0.17699716261039844,Rep (McCain),Rep (Romney),8
south carolina,florence,27611,26491,0,54102,28825,28508,544,57877,134897,-0.02070163764740675,-0.005529101913383217,Rep (McCain),Rep (Romney),9
south carolina,georgetown,15694,14053,0,29747,16476,14119,275,30870,60236,-0.05516522674555417,-0.07703873181892466,Rep (McCain),Rep (Romney),8
south carolina,orangeburg,12037,26978,0,39015,11888,30454,295,42637,92475,0.38295527361271303,0.43847716215577914,Dem (Obama),Dem (Obama),9
south carolina,beaufort,37777,30363,0,68140,42580,29775,760,73115,155550,-0.10880540064572938,-0.1769746389330385,Rep (McCain),Rep (Romney),9
south carolina,saluda,5168,3308,0,8476,5130,3322,101,8553,19567,-0.219443133553563,-0.2139138665404638,Rep (McCain),Rep (Romney),5
south carolina,lexington,70197,31540,0,101737,76392,34007,1805,112204,252563,-0.379969922447094,-0.383925579036042,Rep (McCain),Rep (Romney),10
south carolina,darlington,14532,14475,0,29007,14429,15452,259,30140,68602,-0.00196504292067432,0.034235802014658145,Rep (McCain),Dem (Obama),8
south carolina,fairfield,3912,7591,0,11503,3996,7743,119,11858,24040,0.3198296096670434,0.3191924354715052,Dem (Obama),Dem (Obama),5
south carolina,colleton,8500,8576,0,17076,8439,8470,168,17077,38833,0.004450691028343875,0.0018333431900171505,Dem (Obama),Dem (Obama),7
south carolina,aiken,42706,25982,0,68688,41157,23953,939,66049,156670,-0.2434777544840438,-0.26422976501305484,Rep (McCain),Rep (Romney),9
south carolina,kershaw,16370,11149,0,27519,15846,10821,359,27026,60166,-0.18972346378865512,-0.188435144560693,Rep (McCain),Rep (Romney),8
south carolina,newberry,9607,6689,0,16296,9218,6891,178,16287,37197,-0.1790623465881198,-0.1444534111366317,Rep (McCain),Rep (Romney),7
south carolina,bamberg,2306,4402,0,6708,2190,4600,64,6854,16139,0.3124627310673822,0.3549337260677467,Dem (Obama),Dem (Obama),4
south carolina,union,7447,5925,0,13372,6566,5748,161,12475,29089,-0.11381992222554592,-0.06642845541659899,Rep (McCain),Rep (Romney),6
south carolina,lancaster,16383,12089,0,28472,19273,13345,392,33010,72302,-0.1508148356279854,-0.18174014347906065,Rep (McCain),Rep (Romney),8
south carolina,horry,63580,38414,0,101994,66653,36620,1311,104584,258267,-0.24674000431397924,-0.2908117320112711,Rep (McCain),Rep (Romney),10
south carolina,spartanburg,61216,39661,0,100877,65951,40920,1456,108327,278167,-0.2136760609455079,-0.23421695314912372,Rep (McCain),Rep (Romney),10
south dakota,mcpherson,915,441,0,1356,921,272,22,1215,2506,-0.3495575221238938,-0.5440067057837384,Rep (McCain),Rep (Romney),1
south dakota,hamlin,1659,1043,0,2702,1803,921,69,2793,5761,-0.22797927461139897,-0.3237885462555066,Rep (McCain),Rep (Romney),2
south dakota,douglas,1293,424,0,1717,1334,332,24,1690,3046,-0.5061153174140943,-0.6014405762304922,Rep (McCain),Rep (Romney),1
south dakota,butte,2818,1304,0,4122,3068,1000,133,4201,9888,-0.3672974284327996,-0.5083579154375615,Rep (McCain),Rep (Romney),3
south dakota,bennett,614,557,0,1171,626,548,29,1203,3441,-0.04867634500426986,-0.06643952299829642,Rep (McCain),Rep (Romney),1
south dakota,tripp,1859,914,0,2773,1905,737,49,2691,5743,-0.3407861521817526,-0.4420893262679788,Rep (McCain),Rep (Romney),2
south dakota,miner,577,605,0,1182,636,479,25,1140,2411,0.023688663282571912,-0.14080717488789238,Dem (Obama),Rep (Romney),1
south dakota,day,1372,1785,0,3157,1320,1497,56,2873,5714,0.13082039911308205,0.06283280085197018,Dem (Obama),Dem (Obama),2
south dakota,roberts,1781,2672,0,4453,1883,2302,71,4256,10033,0.2000898270828655,0.1001194743130227,Dem (Obama),Dem (Obama),3
south dakota,hutchinson,2285,1242,0,3527,2451,923,51,3425,7388,-0.29571874113977886,-0.45287492590397155,Rep (McCain),Rep (Romney),2
south dakota,jones,463,147,0,610,490,108,11,609,1076,-0.5180327868852459,-0.6387959866220736,Rep (McCain),Rep (Romney),1
south dakota,mellette,445,373,0,818,381,375,13,769,2032,-0.08801955990220049,-0.007936507936507936,Rep (McCain),Rep (Romney),1
south dakota,deuel,1088,1054,0,2142,1175,941,55,2171,4373,-0.015873015873015872,-0.11058601134215501,Rep (McCain),Rep (Romney),1
south dakota,codington,6374,5595,0,11969,6696,4588,240,11524,27040,-0.06508480240621606,-0.18681318681318682,Rep (McCain),Rep (Romney),6
south dakota,grant,1951,1786,0,3737,2034,1493,79,3606,7382,-0.044153063955044154,-0.15338814856818825,Rep (McCain),Rep (Romney),2
south dakota,corson,535,837,0,1372,515,647,37,1199,4053,0.22011661807580174,0.11359724612736662,Dem (Obama),Dem (Obama),1
south dakota,stanley,1017,510,0,1527,1063,435,42,1540,2896,-0.3320235756385069,-0.4192256341789052,Rep (McCain),Rep (Romney),1
south dakota,hand,1245,718,0,1963,1242,575,31,1848,3402,-0.2684666327050433,-0.3670886075949367,Rep (McCain),Rep (Romney),1
south dakota,turner,2538,1681,0,4219,2715,1411,84,4210,8368,-0.20312870348423798,-0.31604459524963646,Rep (McCain),Rep (Romney),2
south dakota,perkins,1102,499,0,1601,1205,319,66,1590,2976,-0.37663960024984383,-0.5813648293963255,Rep (McCain),Rep (Romney),1
south dakota,marshall,900,1261,0,2161,889,1061,37,1987,4618,0.16705229060620083,0.0882051282051282,Dem (Obama),Dem (Obama),1
south dakota,clay,2296,3808,0,6104,2146,2955,132,5233,13816,0.24770642201834864,0.15859635365614586,Dem (Obama),Dem (Obama),3
south dakota,ziebach,312,554,0,866,314,439,8,761,2765,0.279445727482679,0.16600265604249667,Dem (Obama),Dem (Obama),1
south dakota,pennington,27592,17787,0,45379,28229,15122,1107,44458,97922,-0.216069106855594,-0.3023459666443681,Rep (McCain),Rep (Romney),9
south dakota,meade,7515,3749,0,11264,7560,2928,323,10811,25156,-0.33433948863636365,-0.4416475972540046,Rep (McCain),Rep (Romney),5
south dakota,kingsbury,1435,1277,0,2712,1451,1092,65,2608,5169,-0.05825958702064897,-0.1411718442784113,Rep (McCain),Rep (Romney),1
south dakota,hyde,547,226,0,773,531,189,13,733,1520,-0.4152652005174644,-0.475,Rep (McCain),Rep (Romney),1
south dakota,charlesmix,2102,1805,0,3907,2229,1482,51,3762,9075,-0.0760174046583056,-0.20129345189975748,Rep (McCain),Rep (Romney),2
south dakota,sully,581,233,0,814,611,186,19,816,1328,-0.4275184275184275,-0.533249686323714,Rep (McCain),Rep (Romney),1
south dakota,haakon,938,186,0,1124,940,138,14,1092,1886,-0.6690391459074733,-0.7439703153988868,Rep (McCain),Rep (Romney),1
south dakota,brookings,6431,7207,0,13638,6219,5826,353,12398,31250,0.05689983868602434,-0.03262764632627646,Dem (Obama),Rep (Romney),6
south dakota,aurora,794,655,0,1449,804,556,40,1400,2739,-0.09592822636300898,-0.18235294117647058,Rep (McCain),Rep (Romney),1
south dakota,minnehaha,39241,39831,0,79072,40330,34668,1567,76565,165799,0.0074615540267098344,-0.07549534654257446,Dem (Obama),Rep (Romney),9
south dakota,jackson,668,435,0,1103,661,426,19,1106,2991,-0.2112420670897552,-0.21619135234590617,Rep (McCain),Rep (Romney),1
south dakota,hanson,1426,961,0,2387,1627,760,29,2416,3382,-0.19480519480519481,-0.36321742773355675,Rep (McCain),Rep (Romney),1
south dakota,faulk,739,426,0,1165,765,331,31,1127,2386,-0.2686695278969957,-0.395985401459854,Rep (McCain),Rep (Romney),1
south dakota,yankton,5039,4837,0,9876,5463,4208,253,9924,22216,-0.020453624949372216,-0.12976941371109502,Rep (McCain),Rep (Romney),5
south dakota,potter,937,482,0,1419,1029,339,13,1381,2380,-0.32064834390415786,-0.5043859649122807,Rep (McCain),Rep (Romney),1
south dakota,moody,1508,1663,0,3171,1535,1429,69,3033,6511,0.048880479344055504,-0.03576248313090418,Dem (Obama),Rep (Romney),2
south dakota,mccook,1646,1219,0,2865,1655,905,53,2613,5639,-0.14904013961605583,-0.29296875,Rep (McCain),Rep (Romney),2
south dakota,buffalo,156,454,0,610,166,472,3,641,1932,0.4885245901639344,0.47962382445141066,Dem (Obama),Dem (Obama),1
south dakota,lyman,894,710,0,1604,933,605,31,1569,3736,-0.11471321695760599,-0.21326397919375814,Rep (McCain),Rep (Romney),1
south dakota,harding,575,135,0,710,638,82,19,739,1250,-0.6197183098591549,-0.7722222222222223,Rep (McCain),Rep (Romney),1
south dakota,todd,571,2208,0,2779,498,1976,23,2497,9575,0.5890608132421734,0.597413096200485,Dem (Obama),Dem (Obama),3
south dakota,spink,1660,1550,0,3210,1670,1300,71,3041,6518,-0.03426791277258567,-0.12457912457912458,Rep (McCain),Rep (Romney),2
south dakota,shannon,330,2967,0,3297,188,2922,20,3130,13437,0.7998180163785259,0.8790996784565916,Dem (Obama),Dem (Obama),3
south dakota,gregory,1423,771,0,2194,1507,599,45,2151,4272,-0.29717411121239745,-0.4311490978157645,Rep (McCain),Rep (Romney),1
south dakota,davison,4731,3554,0,8285,4754,3042,172,7968,19397,-0.1420639710319855,-0.21959979476654695,Rep (McCain),Rep (Romney),5
south dakota,edmunds,1213,819,0,2032,1264,622,50,1936,4047,-0.19389763779527558,-0.3404029692470838,Rep (McCain),Rep (Romney),1
south dakota,beadle,4054,3493,0,7547,4230,2881,152,7263,16829,-0.07433417251888168,-0.1897060891576431,Rep (McCain),Rep (Romney),4
south dakota,fallriver,2347,1335,0,3682,2256,1137,118,3511,7078,-0.2748506246605106,-0.3297966401414677,Rep (McCain),Rep (Romney),2
south dakota,hughes,5298,3037,0,8335,5219,2786,150,8155,16827,-0.2712657468506299,-0.30393504059962523,Rep (McCain),Rep (Romney),4
south dakota,campbell,591,243,0,834,616,153,18,787,1431,-0.4172661870503597,-0.6020806241872562,Rep (McCain),Rep (Romney),1
south dakota,brule,1407,965,0,2372,1499,824,56,2379,5128,-0.18634064080944351,-0.290572535514421,Rep (McCain),Rep (Romney),1
south dakota,walworth,1668,923,0,2591,1731,671,60,2462,5408,-0.2875337707448861,-0.4412989175686928,Rep (McCain),Rep (Romney),2
south dakota,dewey,658,1326,0,1984,663,1207,25,1895,5354,0.33669354838709675,0.2909090909090909,Dem (Obama),Dem (Obama),2
south dakota,custer,2909,1475,0,4384,3062,1335,123,4520,8085,-0.3270985401459854,-0.39276779622469865,Rep (McCain),Rep (Romney),2
south dakota,brown,8067,9041,0,17108,8320,7249,497,16066,36011,0.05693242927285481,-0.06879054531440683,Dem (Obama),Rep (Romney),6
south dakota,union,4310,3243,0,7553,4698,2782,116,7596,13903,-0.14126837018403282,-0.25614973262032087,Rep (McCain),Rep (Romney),4
south dakota,sanborn,667,500,0,1167,688,389,38,1115,2380,-0.143101970865467,-0.2776230269266481,Rep (McCain),Rep (Romney),1
south dakota,lincoln,11803,8642,0,20445,13611,7982,359,21952,41289,-0.15460992907801419,-0.26068633353401566,Rep (McCain),Rep (Romney),7
south dakota,jerauld,535,535,0,1070,538,452,16,1006,2038,0,-0.08686868686868687,Rep (McCain),Rep (Romney),1
south dakota,bonhomme,1712,1367,0,3079,1830,1167,77,3074,7080,-0.1120493666774927,-0.22122122122122123,Rep (McCain),Rep (Romney),2
south dakota,lawrence,6787,4932,0,11719,7025,3973,361,11359,23670,-0.15828995648092842,-0.2775050009092562,Rep (McCain),Rep (Romney),5
south dakota,lake,2993,3033,0,6026,3419,2724,142,6285,11008,0.006637902422834384,-0.11313690379293505,Dem (Obama),Rep (Romney),3
south dakota,clark,1065,830,0,1895,1067,713,41,1821,3702,-0.12401055408970976,-0.19887640449438201,Rep (McCain),Rep (Romney),1
tennessee,sevier,24915,8597,0,33512,25979,7415,462,33856,87507,-0.4869300549057054,-0.5559082469904774,Rep (McCain),Rep (Romney),8
tennessee,gibson,13516,7406,0,20922,12883,6564,220,19667,49015,-0.29203709014434565,-0.32493443718825527,Rep (McCain),Rep (Romney),7
tennessee,scott,4931,1720,0,6651,5117,1452,99,6668,22171,-0.48278454367764245,-0.5579235804536459,Rep (McCain),Rep (Romney),5
tennessee,haywood,3165,4891,0,8056,2960,4567,40,7567,19010,0.21425024826216485,0.21349807360170053,Dem (Obama),Dem (Obama),4
tennessee,dyer,9859,4411,0,14270,9921,3757,122,13800,38174,-0.38177995795374914,-0.4506506799239655,Rep (McCain),Rep (Romney),7
tennessee,decatur,3178,1595,0,4773,2873,1302,73,4248,11716,-0.33165723863398283,-0.3762874251497006,Rep (McCain),Rep (Romney),3
tennessee,shelby,143422,253633,0,397055,135536,232201,3012,370749,922696,0.2775711173515004,0.262864492830474,Dem (Obama),Dem (Obama),10
tennessee,polk,4267,2124,0,6391,4108,1856,95,6059,16690,-0.335315287122516,-0.37759892689470154,Rep (McCain),Rep (Romney),4
tennessee,williamson,64843,27879,0,92722,68090,24328,1188,93606,174260,-0.39865404111214164,-0.4735224739769309,Rep (McCain),Rep (Romney),9
tennessee,hawkins,14745,5924,0,20669,14376,5086,327,19789,56562,-0.4267743964391117,-0.4773404583290515,Rep (McCain),Rep (Romney),8
tennessee,hancock,1587,604,0,2191,1527,475,44,2046,6782,-0.44865358283888634,-0.5254745254745254,Rep (McCain),Rep (Romney),2
tennessee,carter,15849,5587,0,21436,15496,4786,325,20607,57710,-0.47872737451016983,-0.5280544325017257,Rep (McCain),Rep (Romney),8
tennessee,hickman,4784,3563,0,8347,4756,2693,146,7595,24506,-0.14628010063495867,-0.27694992616458586,Rep (McCain),Rep (Romney),5
tennessee,marion,6746,4506,0,11252,6268,3952,184,10404,28123,-0.19907571987202274,-0.22661448140900195,Rep (McCain),Rep (Romney),6
tennessee,greene,17148,7107,0,24255,17234,6216,487,23937,68172,-0.4139764996907854,-0.4698507462686567,Rep (McCain),Rep (Romney),8
tennessee,bledsoe,3166,1517,0,4683,3022,1267,70,4359,12946,-0.3521247063847961,-0.4091862905106085,Rep (McCain),Rep (Romney),3
tennessee,anderson,19614,11385,0,30999,18941,10112,568,29621,74257,-0.265460176134714,-0.3038928854163081,Rep (McCain),Rep (Romney),8
tennessee,dickson,11672,7504,0,19176,11287,6228,306,17821,48712,-0.21735502711722987,-0.2888381387382244,Rep (McCain),Rep (Romney),7
tennessee,moore,2010,881,0,2891,2053,705,41,2799,6266,-0.3905223106191629,-0.4887599709934735,Rep (McCain),Rep (Romney),2
tennessee,trousdale,1687,1474,0,3161,1610,1238,53,2901,7751,-0.06738373932299906,-0.1306179775280899,Rep (McCain),Rep (Romney),2
tennessee,grainger,5297,2065,0,7362,5469,1668,113,7250,22419,-0.43901113827764193,-0.5325767129045818,Rep (McCain),Rep (Romney),5
tennessee,cannon,3320,2010,0,5330,3308,1560,100,4968,13631,-0.24577861163227016,-0.3590797041906327,Rep (McCain),Rep (Romney),3
tennessee,lewis,2951,1803,0,4754,3116,1445,130,4691,12003,-0.24148085822465293,-0.36636702477526856,Rep (McCain),Rep (Romney),3
tennessee,fentress,4789,1831,0,6620,5240,1559,91,6890,17777,-0.44682779456193356,-0.5414031475216944,Rep (McCain),Rep (Romney),4
tennessee,vanburen,1293,849,0,2142,1384,875,39,2298,5503,-0.20728291316526612,-0.22532093846834883,Rep (McCain),Rep (Romney),2
tennessee,overton,4495,3418,0,7913,4772,2802,83,7657,21777,-0.13610514343485403,-0.2601003432796409,Rep (McCain),Rep (Romney),5
tennessee,robertson,17903,9318,0,27221,17641,8289,355,26285,64347,-0.3153815069248007,-0.3606633243347474,Rep (McCain),Rep (Romney),8
tennessee,pickett,1786,854,0,2640,1707,711,28,2446,5072,-0.353030303030303,-0.4119106699751861,Rep (McCain),Rep (Romney),1
tennessee,henderson,7669,3021,0,10690,7418,2516,117,10051,27518,-0.43479887745556595,-0.49345681497886046,Rep (McCain),Rep (Romney),6
tennessee,bedford,10215,5026,0,15241,10026,4207,200,14433,44172,-0.34046322419788727,-0.40883861448745873,Rep (McCain),Rep (Romney),7
tennessee,meigs,2795,1371,0,4166,2728,1163,67,3958,11581,-0.3418146903504561,-0.4022102287329735,Rep (McCain),Rep (Romney),3
tennessee,bradley,28324,9353,0,37677,27417,8035,504,35956,97192,-0.5035167343472144,-0.5467110459212456,Rep (McCain),Rep (Romney),9
tennessee,wilson,33767,15462,0,49229,36076,14669,692,51437,109563,-0.3718336752727051,-0.421854369888659,Rep (McCain),Rep (Romney),9
tennessee,chester,4586,1794,0,6380,4672,1622,102,6396,16793,-0.43761755485893417,-0.484588496981252,Rep (McCain),Rep (Romney),4
tennessee,weakley,8853,4594,0,13447,8601,3547,184,12332,34557,-0.3167249200565182,-0.4160355614092855,Rep (McCain),Rep (Romney),6
tennessee,marshall,6755,4319,0,11074,6823,3722,184,10729,29902,-0.21997471554993678,-0.29407302038880984,Rep (McCain),Rep (Romney),6
tennessee,macon,5145,2060,0,7205,5259,1552,93,6904,21934,-0.42817487855655795,-0.5442666275143151,Rep (McCain),Rep (Romney),5
tennessee,davidson,102702,158032,0,260734,94464,138899,4009,237372,612884,0.2122086110748886,0.1904115048229582,Dem (Obama),Dem (Obama),10
tennessee,clay,1674,1248,0,2922,1747,1037,36,2820,7888,-0.1457905544147844,-0.2550287356321839,Rep (McCain),Rep (Romney),2
tennessee,carroll,7454,3980,0,11434,7219,3475,151,10845,28644,-0.3038306804267973,-0.3501028614176174,Rep (McCain),Rep (Romney),6
tennessee,rhea,8033,2905,0,10938,7793,2625,160,10578,31215,-0.4688242823185226,-0.49606450374352085,Rep (McCain),Rep (Romney),6
tennessee,mcminn,12984,5539,0,18523,12958,4603,257,17818,52075,-0.4019327322787885,-0.475770172541427,Rep (McCain),Rep (Romney),7
tennessee,humphreys,3818,3600,0,7418,3829,2904,127,6860,18416,-0.029387975195470477,-0.13738303876429525,Rep (McCain),Rep (Romney),4
tennessee,grundy,2561,1969,0,4530,2502,1637,78,4217,13910,-0.13068432671081678,-0.20898767818313602,Rep (McCain),Rep (Romney),4
tennessee,dekalb,4085,2832,0,6917,4134,2168,104,6406,18569,-0.1811478964869163,-0.3119644557283402,Rep (McCain),Rep (Romney),4
tennessee,houston,1608,1678,0,3286,1579,1400,48,3027,8286,0.02130249543517955,-0.06008727760993622,Dem (Obama),Rep (Romney),2
tennessee,henry,8182,5152,0,13334,8187,4337,207,12731,32042,-0.2272386380680966,-0.30740977323538804,Rep (McCain),Rep (Romney),6
tennessee,blount,35553,15252,0,50805,35417,12925,858,49200,121140,-0.39958665485680545,-0.465268296719209,Rep (McCain),Rep (Romney),9
tennessee,jackson,2185,2284,0,4469,2380,1736,62,4178,11491,0.02215260684716939,-0.1564625850340136,Dem (Obama),Rep (Romney),3
tennessee,hamblen,15501,6804,0,22305,14515,5229,276,20020,61857,-0.3899125756556826,-0.47032009724473256,Rep (McCain),Rep (Romney),8
tennessee,claiborne,7174,3078,0,10252,7617,2433,128,10178,31901,-0.3995317986734296,-0.5158208955223881,Rep (McCain),Rep (Romney),6
tennessee,washington,32216,15894,0,48110,32787,14318,898,48003,119768,-0.339264186239867,-0.39208152000849167,Rep (McCain),Rep (Romney),9
tennessee,monroe,11478,5049,0,16527,11717,4368,235,16320,44015,-0.3889998184788528,-0.45688529686042895,Rep (McCain),Rep (Romney),7
tennessee,hardin,7076,2794,0,9870,7886,2467,142,10495,25995,-0.4338399189463019,-0.5234231623683956,Rep (McCain),Rep (Romney),6
tennessee,mcnairy,7134,3131,0,10265,7010,2643,156,9809,25760,-0.38996590355577204,-0.45239821817051695,Rep (McCain),Rep (Romney),5
tennessee,jefferson,13092,5177,0,18269,13037,4230,298,17565,50600,-0.4332475778641414,-0.5100480685701049,Rep (McCain),Rep (Romney),7
tennessee,benton,3695,2644,0,6339,3850,2255,118,6223,16456,-0.16579902192774887,-0.26126126126126126,Rep (McCain),Rep (Romney),4
tennessee,cocke,8945,3339,0,12284,8459,2804,187,11450,35473,-0.45636600455877563,-0.5020864778478203,Rep (McCain),Rep (Romney),6
tennessee,sumner,44947,21486,0,66433,45979,18571,784,65334,155592,-0.35315280056598375,-0.4246010844306739,Rep (McCain),Rep (Romney),9
tennessee,maury,20282,13057,0,33339,20698,11819,472,32989,79029,-0.21671315876301028,-0.2730571700956423,Rep (McCain),Rep (Romney),8
tennessee,hamilton,81666,64205,0,145871,79877,58794,3649,142320,328960,-0.11970165420131486,-0.15203611425604488,Rep (McCain),Rep (Romney),10
tennessee,sequatchie,3606,1717,0,5323,3541,1488,112,5141,13814,-0.3548750704489949,-0.40823225293298865,Rep (McCain),Rep (Romney),3
tennessee,warren,8558,5515,0,14073,8007,4748,253,13008,39539,-0.21622965963191929,-0.2555076440611525,Rep (McCain),Rep (Romney),7
tennessee,rutherford,59850,40412,0,100262,60829,36400,1587,98816,250517,-0.19387205521533582,-0.2512521984181674,Rep (McCain),Rep (Romney),10
tennessee,morgan,4717,1969,0,6686,4668,1722,110,6500,21664,-0.41100807657792404,-0.4610328638497653,Rep (McCain),Rep (Romney),5
tennessee,unicoi,5011,2106,0,7117,5028,1909,141,7078,18257,-0.40817760292257976,-0.44961799048580076,Rep (McCain),Rep (Romney),4
tennessee,putnam,17098,9735,0,26833,17242,7793,444,25479,70570,-0.27440092423508367,-0.3774315957659277,Rep (McCain),Rep (Romney),8
tennessee,cumberland,17436,7889,0,25325,18651,6260,333,25244,54977,-0.3769792694965449,-0.49741078238529163,Rep (McCain),Rep (Romney),8
tennessee,obion,8873,4308,0,13181,8814,3320,162,12296,31905,-0.3463318412867006,-0.4527773199274765,Rep (McCain),Rep (Romney),6
tennessee,lauderdale,4933,4322,0,9255,4616,4010,62,8688,27745,-0.06601836844948676,-0.07025272432181776,Rep (McCain),Rep (Romney),6
tennessee,johnson,4620,1837,0,6457,4611,1483,100,6194,18190,-0.43100511073253833,-0.5132917623892354,Rep (McCain),Rep (Romney),4
tennessee,cheatham,10697,5497,0,16194,10266,4656,255,15177,38809,-0.321106582684945,-0.37595496582227583,Rep (McCain),Rep (Romney),7
tennessee,fayette,12158,6888,0,19046,12682,6683,197,19562,37458,-0.2766985193741468,-0.30978569584301574,Rep (McCain),Rep (Romney),7
tennessee,coffee,13239,7128,0,20367,13013,5865,364,19242,52344,-0.30004418912947417,-0.3786418052759826,Rep (McCain),Rep (Romney),8
tennessee,wayne,4075,1355,0,5430,4251,1163,70,5484,17016,-0.5009208103130756,-0.5703731067602512,Rep (McCain),Rep (Romney),4
tennessee,sullivan,44802,18346,0,63148,43528,15303,1002,59833,155815,-0.41895230252739596,-0.47976406996311466,Rep (McCain),Rep (Romney),9
tennessee,campbell,6535,3866,0,10401,8602,3327,168,12097,40623,-0.2566099413517931,-0.4421996814485707,Rep (McCain),Rep (Romney),7
tennessee,smith,4561,2990,0,7551,4492,2467,122,7081,19035,-0.2080519136538207,-0.2909900847822963,Rep (McCain),Rep (Romney),4
tennessee,madison,23289,20027,0,43316,21989,18360,342,40691,97378,-0.07530704589528119,-0.08994027113435277,Rep (McCain),Rep (Romney),9
tennessee,crockett,3749,1818,0,5567,3782,1669,46,5497,14524,-0.346865457158254,-0.3876352962759127,Rep (McCain),Rep (Romney),4
tennessee,knox,109847,67923,0,177770,106411,57594,3325,167330,423748,-0.23583281768577374,-0.2976555592817292,Rep (McCain),Rep (Romney),10
tennessee,montgomery,30103,25634,0,55737,30159,24349,916,55424,163603,-0.08018013168990078,-0.10658985836941366,Rep (McCain),Rep (Romney),9
tennessee,franklin,10533,6609,0,17142,10252,5594,253,16099,41054,-0.2289114455722786,-0.2939543102360217,Rep (McCain),Rep (Romney),7
tennessee,tipton,17114,7911,0,25025,16395,7020,267,23682,59689,-0.36775224775224774,-0.40038436899423446,Rep (McCain),Rep (Romney),8
tennessee,stewart,2956,2470,0,5426,2963,2069,83,5115,13133,-0.08956874308883155,-0.17766295707472177,Rep (McCain),Rep (Romney),3
tennessee,perry,1596,1329,0,2925,1578,992,51,2621,7778,-0.09128205128205129,-0.22801556420233463,Rep (McCain),Rep (Romney),2
tennessee,giles,6902,4614,0,11516,6914,3759,124,10797,29558,-0.19868009725599167,-0.2956057340953809,Rep (McCain),Rep (Romney),6
tennessee,union,4461,1828,0,6289,4278,1474,68,5820,19088,-0.4186675147082207,-0.4874826147426982,Rep (McCain),Rep (Romney),5
tennessee,roane,15643,7222,0,22865,14719,6014,348,21081,54156,-0.3682921495735841,-0.41986205566005885,Rep (McCain),Rep (Romney),8
tennessee,lincoln,9226,3694,0,12920,9791,3283,175,13249,32885,-0.4281733746130031,-0.49778185712100353,Rep (McCain),Rep (Romney),6
tennessee,hardeman,5225,5919,0,11144,4864,5479,92,10435,27655,0.06227566403445801,0.05946050468916175,Dem (Obama),Dem (Obama),6
tennessee,white,6100,3369,0,9469,6192,2793,148,9133,25460,-0.2884148273312916,-0.37829716193656093,Rep (McCain),Rep (Romney),5
tennessee,loudon,15815,6058,0,21873,16701,5057,308,22066,47102,-0.4460750697206602,-0.5351594815699973,Rep (McCain),Rep (Romney),7
tennessee,lawrence,10565,5160,0,15725,10770,4237,212,15219,41319,-0.34372019077901433,-0.4353301792496835,Rep (McCain),Rep (Romney),7
tennessee,lake,1175,1024,0,2199,1163,884,40,2087,7827,-0.06866757617098682,-0.13629702002931118,Rep (McCain),Rep (Romney),2
texas,gillespie,9559,2570,0,12129,10305,2055,175,12535,24197,-0.5762222771869074,-0.6674757281553398,Rep (McCain),Rep (Romney),5
texas,king,151,8,0,159,139,5,1,145,219,-0.89937106918239,-0.9305555555555556,Rep (McCain),Rep (Romney),1
texas,webb,13111,33435,0,46546,11074,37592,435,49101,240346,0.4366433205860869,0.5448978753133604,Dem (Obama),Dem (Obama),10
texas,baylor,1262,366,0,1628,1297,267,28,1592,3795,-0.5503685503685504,-0.6585677749360613,Rep (McCain),Rep (Romney),1
texas,falls,2975,1958,0,4933,3356,2033,43,5432,17799,-0.20616257855260492,-0.24550009278159213,Rep (McCain),Rep (Romney),4
texas,lubbock,66028,30295,0,96323,63133,26088,1394,90615,269932,-0.3709705885406393,-0.41520494054090407,Rep (McCain),Rep (Romney),10
texas,kinney,907,633,0,1540,880,522,23,1425,3555,-0.17792207792207793,-0.2553495007132668,Rep (McCain),Rep (Romney),1
texas,cochran,758,284,0,1042,648,256,12,916,3155,-0.45489443378119004,-0.4336283185840708,Rep (McCain),Rep (Romney),1
texas,willacy,1454,3405,0,4859,1415,3595,48,5058,21769,0.40152294710845854,0.4351297405189621,Dem (Obama),Dem (Obama),5
texas,hemphill,1342,216,0,1558,1298,192,19,1509,3668,-0.7227214377406932,-0.7422818791946308,Rep (McCain),Rep (Romney),1
texas,borden,316,40,0,356,324,32,6,362,564,-0.7752808988764045,-0.8202247191011236,Rep (McCain),Rep (Romney),1
texas,dimmit,874,2692,0,3566,762,2141,14,2917,9908,0.5098149186763881,0.4750258353427489,Dem (Obama),Dem (Obama),3
texas,bastrop,13797,11678,0,25475,14019,9860,578,24457,72289,-0.08317958783120706,-0.17416977260354286,Rep (McCain),Rep (Romney),8
texas,burnet,12034,4596,0,16630,12828,3672,270,16770,42215,-0.4472639807576669,-0.5549090909090909,Rep (McCain),Rep (Romney),7
texas,wharton,9427,4935,0,14362,9750,4235,102,14087,41036,-0.31276980921877173,-0.3943510904540579,Rep (McCain),Rep (Romney),7
texas,travis,136671,253278,0,389949,139503,231540,13847,384890,979712,0.29903141180000464,0.24804941745296366,Dem (Obama),Dem (Obama),10
texas,oldham,813,102,0,915,786,71,8,865,2020,-0.7770491803278688,-0.8343057176196033,Rep (McCain),Rep (Romney),1
texas,lampasas,5628,1895,0,7523,5583,1457,98,7138,19677,-0.4962116177057025,-0.5860795454545454,Rep (McCain),Rep (Romney),5
texas,howard,7020,2539,0,9559,4032,1042,65,5139,34285,-0.4687728841929072,-0.5892786756011037,Rep (McCain),Rep (Romney),6
texas,fortbend,102846,98136,0,200982,116028,101043,2179,219250,541983,-0.02343493447174374,-0.06903271279903811,Rep (McCain),Rep (Romney),10
texas,redriver,3461,1538,0,4999,3549,1482,43,5074,12987,-0.3846769353870774,-0.4108527131782946,Rep (McCain),Rep (Romney),3
texas,orange,21509,7646,0,29155,23361,6797,344,30502,82014,-0.475493054364603,-0.5492406658266463,Rep (McCain),Rep (Romney),8
texas,motley,522,67,0,589,538,55,6,599,1123,-0.7724957555178268,-0.8145025295109612,Rep (McCain),Rep (Romney),1
texas,kenedy,93,108,0,201,83,82,1,166,241,0.07462686567164178,-0.006060606060606061,Dem (Obama),Rep (Romney),1
texas,kendall,12960,3591,0,16551,14467,3035,227,17729,31515,-0.566068515497553,-0.6531824934293223,Rep (McCain),Rep (Romney),6
texas,mclennan,49005,29959,0,78964,47885,25688,920,74493,229587,-0.241198520844942,-0.30170035203131584,Rep (McCain),Rep (Romney),10
texas,schleicher,969,322,0,1291,781,220,9,1010,3343,-0.5011618900077459,-0.5604395604395604,Rep (McCain),Rep (Romney),1
texas,kerr,16729,5564,0,22293,17225,4325,261,21811,48826,-0.5008298569057552,-0.5986078886310905,Rep (McCain),Rep (Romney),7
texas,camp,2794,1733,0,4527,2878,1428,26,4332,12288,-0.23437154848685665,-0.3367394333488156,Rep (McCain),Rep (Romney),3
texas,cooke,11871,3051,0,14922,11901,2240,150,14291,38316,-0.5910735826296744,-0.6831907220140019,Rep (McCain),Rep (Romney),7
texas,culberson,267,510,0,777,294,566,16,876,2480,0.3127413127413127,0.31627906976744186,Dem (Obama),Dem (Obama),1
texas,sanpatricio,12390,8842,0,21232,11994,7854,216,20064,66100,-0.1671062547098719,-0.20858524788391777,Rep (McCain),Rep (Romney),8
texas,jackson,3560,1251,0,4811,3903,1068,47,5018,13987,-0.4799418000415714,-0.5703077851538926,Rep (McCain),Rep (Romney),4
texas,sansaba,1941,487,0,2428,1905,323,28,2256,6023,-0.5988467874794069,-0.7100538599640933,Rep (McCain),Rep (Romney),2
texas,wheeler,1916,314,0,2230,1878,232,18,2128,5235,-0.7183856502242153,-0.7800947867298578,Rep (McCain),Rep (Romney),1
texas,mills,1753,398,0,2151,1882,279,36,2197,4887,-0.6299395629939563,-0.7417862100879222,Rep (McCain),Rep (Romney),1
texas,liberty,15417,5980,0,21397,17304,5196,211,22711,74922,-0.44104313688834884,-0.5381333333333334,Rep (McCain),Rep (Romney),8
texas,coke,1252,297,0,1549,1216,179,11,1406,3301,-0.6165267914783732,-0.7433691756272401,Rep (McCain),Rep (Romney),1
texas,cottle,509,187,0,696,553,180,6,739,1618,-0.46264367816091956,-0.5088676671214188,Rep (McCain),Rep (Romney),1
texas,fisher,1083,687,0,1770,1094,512,22,1628,4057,-0.22372881355932203,-0.36239103362391034,Rep (McCain),Rep (Romney),1
texas,young,5938,1302,0,7240,6225,992,99,7316,18298,-0.6403314917127072,-0.725093529167244,Rep (McCain),Rep (Romney),4
texas,palopinto,7264,2499,0,9763,7392,1810,133,9335,27927,-0.4880671924613336,-0.6066072592914584,Rep (McCain),Rep (Romney),6
texas,valverde,5752,6982,0,12734,5612,6267,161,12040,48088,0.0965918014763625,0.055139321491708054,Dem (Obama),Dem (Obama),7
texas,somervell,2675,798,0,3473,2858,609,40,3507,8200,-0.540454938093867,-0.6486876261897895,Rep (McCain),Rep (Romney),2
texas,presidio,489,1250,0,1739,504,1273,31,1808,7703,0.437607820586544,0.43275182892515474,Dem (Obama),Dem (Obama),2
texas,kent,342,99,0,441,334,66,4,404,772,-0.5510204081632653,-0.67,Rep (McCain),Rep (Romney),1
texas,rockwall,23243,8468,0,31711,27098,8112,441,35651,73311,-0.4659266500583394,-0.5392218119852314,Rep (McCain),Rep (Romney),8
texas,denton,149592,90830,0,240422,156105,79917,4103,240125,628084,-0.244411909059903,-0.32280041691028805,Rep (McCain),Rep (Romney),10
texas,madison,2883,1144,0,4027,3028,964,33,4025,13433,-0.4318351129873355,-0.5170340681362725,Rep (McCain),Rep (Romney),3
texas,crockett,1026,512,0,1538,957,480,20,1457,3746,-0.3342002600780234,-0.33194154488517746,Rep (McCain),Rep (Romney),1
texas,freestone,5201,2032,0,7233,5644,1848,70,7562,19461,-0.43813078943730127,-0.5066737853710624,Rep (McCain),Rep (Romney),5
texas,galveston,61844,41543,0,103387,68594,39162,1471,109227,286326,-0.1963593101647209,-0.27313560265785664,Rep (McCain),Rep (Romney),10
texas,sterling,520,97,0,617,459,31,4,494,1160,-0.6855753646677472,-0.8734693877551021,Rep (McCain),Rep (Romney),1
texas,knox,986,366,0,1352,1160,332,18,1510,3708,-0.45857988165680474,-0.5549597855227882,Rep (McCain),Rep (Romney),1
texas,duval,1076,3298,0,4374,979,3331,33,4343,11999,0.5080018289894833,0.545707656612529,Dem (Obama),Dem (Obama),3
texas,childress,1782,497,0,2279,1665,320,11,1996,7115,-0.5638437911364633,-0.6775818639798489,Rep (McCain),Rep (Romney),2
texas,shackelford,1284,208,0,1492,1218,131,14,1363,3182,-0.7211796246648794,-0.8057820607857672,Rep (McCain),Rep (Romney),1
texas,harrison,17085,8874,0,25959,17471,8431,197,26099,64484,-0.3163064833005894,-0.3490077986255888,Rep (McCain),Rep (Romney),8
texas,brown,12049,2819,0,14868,11894,1904,138,13936,38199,-0.6207963411353242,-0.7240179736193652,Rep (McCain),Rep (Romney),7
texas,coleman,3011,643,0,3654,3007,441,35,3483,8857,-0.6480569239189928,-0.744199535962877,Rep (McCain),Rep (Romney),2
texas,randall,41895,9461,0,51356,41366,7553,669,49588,116811,-0.6315523015811201,-0.6912038267339888,Rep (McCain),Rep (Romney),9
texas,haskell,1388,699,0,2087,1422,551,33,2006,5842,-0.33013895543842836,-0.4414597060314242,Rep (McCain),Rep (Romney),2
texas,comal,35203,12365,0,47568,39291,11437,747,51475,102836,-0.480112680793811,-0.5490853177732219,Rep (McCain),Rep (Romney),9
texas,hardeman,1199,373,0,1572,1176,302,17,1495,4226,-0.5254452926208651,-0.59133964817320706,Rep (McCain),Rep (Romney),1
texas,carson,2547,406,0,2953,2450,292,33,2775,6284,-0.7250253979004402,-0.7870167760758571,Rep (McCain),Rep (Romney),2
texas,uvalde,4585,4120,0,8705,4526,3824,81,8431,26285,-0.053417576105686385,-0.08407185628742515,Rep (McCain),Rep (Romney),6
texas,hood,17269,5078,0,22347,18341,3829,275,22445,49816,-0.545531838725556,-0.6545782589084348,Rep (McCain),Rep (Romney),7
texas,shelby,6629,2546,0,9175,6870,2318,73,9261,25423,-0.44501362397820166,-0.4954288202002612,Rep (McCain),Rep (Romney),5
texas,hays,29624,28416,0,58040,31577,25448,1783,58808,146439,-0.020813232253618193,-0.10747917580008769,Rep (McCain),Rep (Romney),9
texas,archer,3591,739,0,4330,3599,525,39,4163,9055,-0.6586605080831409,-0.7453928225024248,Rep (McCain),Rep (Romney),2
texas,bandera,6934,2248,0,9182,7423,1859,152,9434,20265,-0.510346329775648,-0.5994397759103641,Rep (McCain),Rep (Romney),5
texas,hidalgo,39614,90122,0,129736,39786,97879,1301,138966,736973,0.38931368317198,0.4219881596629499,Dem (Obama),Dem (Obama),10
texas,austin,8777,2819,0,11596,9260,2252,116,11628,27783,-0.5137978613314936,-0.6087560806115357,Rep (McCain),Rep (Romney),6
texas,jimhogg,472,1336,0,1808,356,1301,10,1667,5211,0.4778761061946903,0.5703077851538926,Dem (Obama),Dem (Obama),1
texas,hutchinson,7358,1321,0,8679,6797,1042,77,7916,22094,-0.6955870491992165,-0.7341497640005102,Rep (McCain),Rep (Romney),5
texas,lee,4312,2000,0,6312,4504,1630,77,6211,16499,-0.36628643852978454,-0.4685360286925334,Rep (McCain),Rep (Romney),4
texas,anderson,11855,4624,0,16479,12235,3796,136,16167,58016,-0.4388008981127496,-0.526417565965941,Rep (McCain),Rep (Romney),8
texas,moore,4282,1123,0,5405,3967,963,53,4983,21102,-0.584458834412581,-0.6093306288032454,Rep (McCain),Rep (Romney),5
texas,briscoe,616,205,0,821,576,117,7,700,1723,-0.5006090133982948,-0.6623376623376623,Rep (McCain),Rep (Romney),1
texas,titus,6023,3140,0,9163,6062,2638,90,8790,30995,-0.31463494488704574,-0.3935632183908046,Rep (McCain),Rep (Romney),6
texas,tyler,5633,2159,0,7792,5889,1659,75,7623,21472,-0.44584188911704314,-0.5604133545310016,Rep (McCain),Rep (Romney),5
texas,brewster,1781,1819,0,3600,1975,1765,126,3866,8971,0.010555555555555556,-0.05614973262032086,Dem (Obama),Rep (Romney),2
texas,stephens,2869,626,0,3495,2891,475,41,3407,9562,-0.6417739628040057,-0.7177658942364825,Rep (McCain),Rep (Romney),3
texas,henderson,20810,7890,0,28700,21202,6094,286,27582,78299,-0.45017421602787455,-0.5534876905041032,Rep (McCain),Rep (Romney),8
texas,wood,13638,3996,0,17634,14317,3052,172,17541,41625,-0.5467846206192583,-0.648569290114572,Rep (McCain),Rep (Romney),7
texas,rusk,13641,4983,0,18624,13924,4451,162,18537,52016,-0.4648840206185567,-0.5155374149659864,Rep (McCain),Rep (Romney),7
texas,irion,644,164,0,808,668,112,8,788,1673,-0.594059405940594,-0.7128205128205128,Rep (McCain),Rep (Romney),1
texas,sanaugustine,2338,1327,0,3665,2469,1193,28,3690,8996,-0.27585266030013644,-0.3484434735117422,Rep (McCain),Rep (Romney),2
texas,ochiltree,2851,243,0,3094,2718,253,19,2990,9953,-0.8429217840982547,-0.8296869740828005,Rep (McCain),Rep (Romney),3
texas,hill,9220,3802,0,13022,9128,2745,159,12032,34854,-0.41606512056519734,-0.5376063336983071,Rep (McCain),Rep (Romney),6
texas,clay,4213,1085,0,5298,4266,740,50,5056,10922,-0.59041147602869,-0.7043547742708749,Rep (McCain),Rep (Romney),3
texas,milam,5215,3040,0,8255,5478,2632,110,8220,24934,-0.2634766807995155,-0.350924784217016,Rep (McCain),Rep (Romney),5
texas,kaufman,23727,11157,0,34884,24804,9451,349,34604,98402,-0.36033711730306156,-0.4481973434535104,Rep (McCain),Rep (Romney),9
texas,bailey,1618,680,0,2298,1336,466,11,1813,7027,-0.4081810269799826,-0.4827968923418424,Rep (McCain),Rep (Romney),2
texas,cherokee,11693,4605,0,16298,12291,3935,161,16387,50035,-0.43489998772855565,-0.5149759645014175,Rep (McCain),Rep (Romney),7
texas,runnels,3118,720,0,3838,3103,517,45,3665,10492,-0.62480458572173,-0.7143646408839779,Rep (McCain),Rep (Romney),3
texas,ector,26190,9118,0,35308,23936,8095,377,32408,133015,-0.4835164835164835,-0.4945521526021667,Rep (McCain),Rep (Romney),9
texas,ward,2667,899,0,3566,2364,836,38,3238,10505,-0.49579360628154795,-0.4775,Rep (McCain),Rep (Romney),3
texas,sherman,493,78,0,571,908,121,9,1038,3000,-0.7267950963222417,-0.7648202137998056,Rep (McCain),Rep (Romney),1
texas,potter,20741,8932,0,29673,18905,7114,399,26418,120124,-0.39797121962727056,-0.45316883815673165,Rep (McCain),Rep (Romney),9
texas,castro,1561,719,0,2280,1470,630,19,2119,7848,-0.36929824561403507,-0.4,Rep (McCain),Rep (Romney),2
texas,lamb,3344,1156,0,4500,3056,998,35,4089,14092,-0.4862222222222222,-0.5076467686235816,Rep (McCain),Rep (Romney),4
texas,bowie,24136,10801,0,34937,24840,10184,333,35357,91399,-0.3816870366659988,-0.41845591594335313,Rep (McCain),Rep (Romney),9
texas,burleson,4546,2053,0,6599,4671,1705,79,6455,17058,-0.37778451280497044,-0.4651819322459222,Rep (McCain),Rep (Romney),4
texas,parmer,2969,719,0,3688,2005,528,12,2545,10098,-0.6100867678958786,-0.5831030398736676,Rep (McCain),Rep (Romney),3
texas,dickens,730,234,0,964,793,216,10,1019,2441,-0.5145228215767634,-0.5718533201189296,Rep (McCain),Rep (Romney),1
texas,eastland,5163,1271,0,6434,5443,970,81,6494,18560,-0.6049114081442337,-0.6974894745049119,Rep (McCain),Rep (Romney),4
texas,refugio,1853,1382,0,3235,1659,998,16,2673,7434,-0.1455950540958269,-0.2487768159578472,Rep (McCain),Rep (Romney),2
texas,cass,8276,3489,0,11765,8747,2921,96,11764,30254,-0.406884827879303,-0.49931436407267743,Rep (McCain),Rep (Romney),6
texas,collingsworth,1052,292,0,1344,962,177,11,1150,3009,-0.5654761904761905,-0.6892010535557507,Rep (McCain),Rep (Romney),1
texas,wichita,31673,13828,0,45501,29756,10490,677,40923,130976,-0.39218918265532626,-0.4787059583561099,Rep (McCain),Rep (Romney),9
texas,nueces,52264,47811,0,100075,48779,45666,1336,95781,334370,-0.04449662752935298,-0.032960982582455396,Rep (McCain),Rep (Romney),10
texas,nacogdoches,14828,8393,0,23221,13910,6441,250,20601,63141,-0.27711984841307435,-0.36700899218711613,Rep (McCain),Rep (Romney),8
texas,lipscomb,1092,155,0,1247,1044,119,5,1168,3218,-0.7514033680834001,-0.7953568357695615,Rep (McCain),Rep (Romney),1
texas,fannin,8090,3464,0,11554,8143,2482,156,10781,33765,-0.4003808204950666,-0.5328,Rep (McCain),Rep (Romney),6
texas,trinity,4091,1924,0,6015,4537,1614,83,6234,14451,-0.3602660016625104,-0.47520728336855794,Rep (McCain),Rep (Romney),4
texas,tarrant,347843,274101,0,621944,348686,252789,8674,610149,1743300,-0.11856694493394904,-0.1594363855521842,Rep (McCain),Rep (Romney),10
texas,liveoak,3079,1038,0,4117,3153,915,40,4108,11507,-0.4957493320378917,-0.5501474926253688,Rep (McCain),Rep (Romney),3
texas,hockley,5789,1794,0,7583,5543,1482,94,7119,22933,-0.5268363444547013,-0.5780782918149466,Rep (McCain),Rep (Romney),5
texas,edwards,673,346,0,1019,641,232,10,883,2029,-0.3209028459273798,-0.46849942726231386,Rep (McCain),Rep (Romney),1
texas,martin,1389,314,0,1703,1338,247,8,1593,4606,-0.631238990017616,-0.6883280757097792,Rep (McCain),Rep (Romney),1
texas,elpaso,61598,121589,0,183187,56517,112273,2263,171053,772280,0.32748502895947856,0.3303276260441969,Dem (Obama),Dem (Obama),10
texas,guadalupe,30750,16070,0,46820,32959,15654,634,49247,122728,-0.31354122170012816,-0.3559747392672742,Rep (McCain),Rep (Romney),9
texas,parker,36646,10429,0,47075,38980,7804,562,47346,112158,-0.5569198088157196,-0.6663816689466484,Rep (McCain),Rep (Romney),9
texas,loving,67,12,0,79,54,9,1,64,41,-0.6962025316455697,-0.7142857142857143,Rep (McCain),Rep (Romney),1
texas,lavaca,6286,1867,0,8153,6788,1427,64,8279,19217,-0.5420090764135901,-0.6525867315885575,Rep (McCain),Rep (Romney),5
texas,foard,327,208,0,535,346,140,7,493,1379,-0.22242990654205608,-0.42386831275720166,Rep (McCain),Rep (Romney),1
texas,gregg,29159,13130,0,42289,28665,12336,355,41356,119525,-0.3790347371656932,-0.3982585790590473,Rep (McCain),Rep (Romney),9
texas,upshur,5871,2106,0,7977,11948,2953,148,15049,38685,-0.47198194810078975,-0.603650761693846,Rep (McCain),Rep (Romney),7
texas,lamar,12940,5240,0,18180,12814,4173,186,17173,49536,-0.4235423542354235,-0.508683110613999,Rep (McCain),Rep (Romney),7
texas,chambers,9966,3185,0,13151,11761,2780,151,14692,32371,-0.5156261881225762,-0.6176329000756482,Rep (McCain),Rep (Romney),6
texas,terry,2863,1379,0,4242,2602,1059,46,3707,12498,-0.34983498349834985,-0.42146954384048074,Rep (McCain),Rep (Romney),3
texas,starr,1488,8233,0,9721,1540,10248,71,11859,59989,0.6938586565168192,0.7387173396674585,Dem (Obama),Dem (Obama),8
texas,kimble,1487,341,0,1828,1667,217,7,1891,4568,-0.6269146608315098,-0.7696390658174098,Rep (McCain),Rep (Romney),1
texas,angelina,19569,9377,0,28946,20301,7833,269,28403,85254,-0.35210391763974297,-0.44316485391341437,Rep (McCain),Rep (Romney),8
texas,ellis,38046,15315,0,53361,39353,13803,600,53756,143502,-0.4259852701411143,-0.48066069681691626,Rep (McCain),Rep (Romney),9
texas,gray,6920,1153,0,8073,6428,885,60,7373,22497,-0.7143564969651927,-0.7579652673321482,Rep (McCain),Rep (Romney),5
texas,crosby,1221,684,0,1905,1132,639,16,1787,6207,-0.28188976377952757,-0.27837380011293056,Rep (McCain),Rep (Romney),2
texas,medina,10404,5119,0,15523,11016,4760,172,15948,45073,-0.3404625394575791,-0.39655172413793105,Rep (McCain),Rep (Romney),7
texas,williamson,87938,67347,0,155285,96910,61812,4214,162936,391715,-0.1326013459123547,-0.22112876601857334,Rep (McCain),Rep (Romney),10
texas,jack,2527,470,0,2997,2580,303,24,2907,9072,-0.686353019686353,-0.7898022892819979,Rep (McCain),Rep (Romney),2
texas,atascosa,5546,4400,0,9946,7451,5128,125,12704,44049,-0.11522219987934848,-0.18467286747754194,Rep (McCain),Rep (Romney),7
texas,bosque,5760,1796,0,7556,5873,1366,97,7336,18067,-0.5246161990471149,-0.622599806603122,Rep (McCain),Rep (Romney),4
texas,sutton,1189,381,0,1570,1110,369,10,1489,4257,-0.5146496815286624,-0.5010141987829615,Rep (McCain),Rep (Romney),1
texas,yoakum,1989,450,0,2439,1698,409,21,2128,7706,-0.6309963099630996,-0.6117702895111533,Rep (McCain),Rep (Romney),2
texas,terrell,323,186,0,509,358,184,11,553,850,-0.2691552062868369,-0.3210332103321033,Rep (McCain),Rep (Romney),1
texas,wilbarger,3279,1196,0,4475,2956,971,53,3980,13637,-0.46547486033519553,-0.5054749172396231,Rep (McCain),Rep (Romney),3
texas,robertson,3979,2674,0,6653,4416,2792,70,7278,16574,-0.19615211182924996,-0.2253052164261931,Rep (McCain),Rep (Romney),4
texas,delta,1580,589,0,2169,1524,454,40,2018,5248,-0.4568925772245274,-0.5409504550050556,Rep (McCain),Rep (Romney),2
texas,stonewall,524,206,0,730,507,160,8,675,1434,-0.43561643835616437,-0.52023988005997,Rep (McCain),Rep (Romney),1
texas,blanco,3417,1466,0,4883,3637,1220,114,4971,10085,-0.39954945730083963,-0.4976322833024501,Rep (McCain),Rep (Romney),3
texas,hansford,1847,239,0,2086,1787,158,15,1960,5470,-0.7708533077660594,-0.8375321336760926,Rep (McCain),Rep (Romney),2
texas,brooks,556,1747,0,2303,507,1886,10,2403,7349,0.5171515414676509,0.5762641036356039,Dem (Obama),Dem (Obama),2
texas,menard,712,295,0,1007,663,170,13,846,2212,-0.4141012909632572,-0.5918367346938775,Rep (McCain),Rep (Romney),1
texas,reeves,1444,1605,0,3049,1185,1649,33,2867,13269,0.05280419809773696,0.16372618207480594,Dem (Obama),Dem (Obama),3
texas,mason,1543,546,0,2089,1562,380,23,1965,3928,-0.47726184777405456,-0.6086508753861998,Rep (McCain),Rep (Romney),1
texas,andrews,3815,790,0,4605,3636,794,46,4476,14048,-0.6568946796959826,-0.6415349887133183,Rep (McCain),Rep (Romney),4
texas,hale,7139,2693,0,9832,6417,2228,120,8765,36041,-0.4521969080553295,-0.48455754771544246,Rep (McCain),Rep (Romney),6
texas,concho,807,257,0,1064,793,194,14,1001,4047,-0.5169172932330827,-0.6068895643363729,Rep (McCain),Rep (Romney),1
texas,hardin,16589,3935,0,20524,17744,3358,191,21293,53220,-0.6165464821672189,-0.6817363283101128,Rep (McCain),Rep (Romney),8
texas,vanzandt,15727,4503,0,20230,15790,3083,208,19081,52362,-0.5548195748887791,-0.6732898850209293,Rep (McCain),Rep (Romney),8
texas,jefferson,42877,44854,0,87731,43214,44626,708,88548,249349,0.022534793858499276,0.016074681238615666,Dem (Obama),Dem (Obama),10
texas,lasalle,713,1051,0,1764,669,965,12,1646,6709,0.19160997732426305,0.18115055079559364,Dem (Obama),Dem (Obama),2
texas,hamilton,2875,862,0,3737,2918,591,42,3551,8473,-0.5386673802515387,-0.6631518951268167,Rep (McCain),Rep (Romney),2
texas,hunt,20571,8591,0,29162,20976,6658,350,27984,84836,-0.4108085865166998,-0.5181298400521097,Rep (McCain),Rep (Romney),8
texas,collin,184116,108208,0,292324,195933,100754,4414,301101,738745,-0.2596707762619559,-0.3208061020536795,Rep (McCain),Rep (Romney),10
texas,mcculloch,2263,728,0,2991,2419,537,37,2993,8220,-0.5132062855232363,-0.6366711772665764,Rep (McCain),Rep (Romney),2
texas,leon,5563,1415,0,6978,5812,1061,68,6941,16640,-0.5944396675265119,-0.6912556380037829,Rep (McCain),Rep (Romney),4
texas,dawson,2894,1135,0,4029,2591,1017,32,3640,13853,-0.43658476048647304,-0.4362527716186253,Rep (McCain),Rep (Romney),4
texas,floyd,1784,729,0,2513,1523,551,11,2085,6599,-0.41981695185037804,-0.4686595949855352,Rep (McCain),Rep (Romney),2
texas,waller,8238,7107,0,15345,9158,6401,140,15699,40831,-0.07370478983382209,-0.17719647792274568,Rep (McCain),Rep (Romney),7
texas,mcmullen,400,131,0,531,436,67,5,508,897,-0.5065913370998116,-0.7335984095427436,Rep (McCain),Rep (Romney),1
texas,montague,6235,1594,0,7829,6539,1116,82,7737,19789,-0.5927960148167071,-0.70842586544742,Rep (McCain),Rep (Romney),5
texas,llano,7279,2250,0,9529,7560,1818,124,9502,18992,-0.5277573722321335,-0.6122840690978887,Rep (McCain),Rep (Romney),4
texas,jeffersondavis,746,467,0,1213,717,440,31,1188,2340,-0.23000824402308326,-0.2394122731201383,Rep (McCain),Rep (Romney),1
texas,upton,898,288,0,1186,952,332,14,1298,3243,-0.5143338954468802,-0.48286604361370716,Rep (McCain),Rep (Romney),1
texas,brazoria,67444,36461,0,103905,70684,34327,1411,106422,300522,-0.29818584283720706,-0.34622087209911345,Rep (McCain),Rep (Romney),10
texas,caldwell,6084,5385,0,11469,6018,4787,250,11055,37416,-0.060946900340047086,-0.11392873669597409,Rep (McCain),Rep (Romney),7
texas,swisher,1676,812,0,2488,1654,579,32,2265,7828,-0.34726688102893893,-0.48141513658755036,Rep (McCain),Rep (Romney),2
texas,maverick,2316,8554,0,10870,2171,8302,89,10562,52493,0.5738730450781969,0.5854101021674782,Dem (Obama),Dem (Obama),8
texas,tomgreen,27201,11068,0,38269,26749,9246,532,36527,108000,-0.4215683712665604,-0.4862619808306709,Rep (McCain),Rep (Romney),9
texas,hall,930,324,0,1254,832,265,11,1108,3424,-0.48325358851674644,-0.5168641750227895,Rep (McCain),Rep (Romney),1
texas,hopkins,9297,3528,0,12825,9834,2775,133,12742,34540,-0.4498245614035088,-0.5598382108018082,Rep (McCain),Rep (Romney),6
texas,montgomery,119542,36530,0,156072,137822,32852,2146,172820,427717,-0.5318827207955302,-0.615032166586592,Rep (McCain),Rep (Romney),10
texas,jimwells,4825,6683,0,11508,4595,6492,76,11163,40631,0.16145290232881473,0.17110128979886352,Dem (Obama),Dem (Obama),7
texas,franklin,3394,1094,0,4488,3446,750,59,4255,10675,-0.5124777183600713,-0.6425166825548141,Rep (McCain),Rep (Romney),3
texas,walker,11610,7323,0,18933,9569,5283,214,15066,66353,-0.22643004278244336,-0.2885806625370321,Rep (McCain),Rep (Romney),8
texas,real,1237,375,0,1612,1236,277,20,1533,3279,-0.5347394540942928,-0.6338400528750826,Rep (McCain),Rep (Romney),1
texas,bee,4467,3645,0,8112,4354,3451,68,7873,31896,-0.10133136094674557,-0.11569506726457399,Rep (McCain),Rep (Romney),6
texas,gonzales,4062,2158,0,6220,4213,1773,53,6039,19635,-0.30610932475884245,-0.4076177748078851,Rep (McCain),Rep (Romney),5
texas,newton,3440,1750,0,5190,4399,1721,68,6188,14389,-0.325626204238921,-0.43758169934640523,Rep (McCain),Rep (Romney),4
texas,aransas,6691,3005,0,9696,6829,2703,114,9646,23247,-0.38015676567656764,-0.43285774234158625,Rep (McCain),Rep (Romney),5
texas,dewitt,4888,1715,0,6603,5114,1463,47,6624,20025,-0.480539148871725,-0.5551163144290711,Rep (McCain),Rep (Romney),5
texas,matagorda,11929,6682,0,18611,8026,3972,112,12110,36647,-0.28193004137338135,-0.33788964827471246,Rep (McCain),Rep (Romney),7
texas,callahan,4589,1063,0,5652,4376,751,68,5195,13458,-0.6238499646142959,-0.7070411546713478,Rep (McCain),Rep (Romney),3
texas,comanche,3807,1339,0,5146,3940,890,67,4897,13863,-0.4795958025650991,-0.6314699792960663,Rep (McCain),Rep (Romney),4
texas,colorado,5790,2503,0,8293,6015,2024,56,8095,20751,-0.3963583745327385,-0.49645478293320067,Rep (McCain),Rep (Romney),5
texas,midland,36135,9672,0,45807,35452,8223,602,44277,132103,-0.5777064640775428,-0.623445907269605,Rep (McCain),Rep (Romney),9
texas,polk,13703,6215,0,19918,14019,4836,203,19058,45590,-0.37594135957425445,-0.4870326173428799,Rep (McCain),Rep (Romney),7
texas,coryell,11537,6611,0,18148,11193,5141,217,16551,74082,-0.2714348688560723,-0.3705154891637076,Rep (McCain),Rep (Romney),8
texas,zapata,918,1939,0,2857,993,2517,19,3529,13609,0.35736786839341966,0.4341880341880342,Dem (Obama),Dem (Obama),3
texas,roberts,477,41,0,518,408,25,6,439,877,-0.8416988416988417,-0.8845265588914549,Rep (McCain),Rep (Romney),1
texas,navarro,10803,5399,0,16202,10838,4348,130,15316,47483,-0.3335390692507098,-0.4273673119978928,Rep (McCain),Rep (Romney),7
texas,donley,1370,291,0,1661,1286,226,21,1533,3655,-0.6496086694762191,-0.701058201058201,Rep (McCain),Rep (Romney),1
texas,grimes,5561,2704,0,8265,6141,2339,118,8598,26208,-0.3456745311554749,-0.4483490566037736,Rep (McCain),Rep (Romney),6
texas,scurry,4414,1088,0,5502,4121,837,64,5022,16579,-0.6045074518356961,-0.6623638563937071,Rep (McCain),Rep (Romney),4
texas,erath,10757,3126,0,13883,10325,1965,177,12467,37142,-0.5496650579845854,-0.6802278275020341,Rep (McCain),Rep (Romney),7
texas,jones,4197,1525,0,5722,4258,1225,79,5562,20157,-0.4669695910520797,-0.553164326098851,Rep (McCain),Rep (Romney),5
texas,harris,570143,588611,0,1158754,584866,585451,15161,1185478,3950999,0.015937809060421797,4.998645666088761e-4,Dem (Obama),Dem (Obama),10
texas,marion,2566,1644,0,4210,2730,1487,54,4271,10771,-0.2190023752969121,-0.2947593075646194,Rep (McCain),Rep (Romney),3
texas,frio,1644,2405,0,4049,1559,2376,33,3968,16956,0.18794764139293652,0.2076238881829733,Dem (Obama),Dem (Obama),4
texas,cameron,26641,48401,0,75042,24955,49159,688,74802,393566,0.28997094960155645,0.32657797447175974,Dem (Obama),Dem (Obama),10
texas,pecos,2480,1476,0,3956,2512,1591,44,4147,15400,-0.2537917087967644,-0.22446990007311723,Rep (McCain),Rep (Romney),4
texas,rains,3130,1041,0,4171,3265,754,46,4065,10942,-0.5008391273076,-0.6247822841502861,Rep (McCain),Rep (Romney),3
texas,calhoun,4106,2727,0,6833,4145,2510,91,6746,21120,-0.2018147226693985,-0.24567993989481593,Rep (McCain),Rep (Romney),5
texas,wilson,10903,5360,0,16263,12205,4819,162,17186,41264,-0.3408350242882617,-0.4338580827067669,Rep (McCain),Rep (Romney),7
texas,kleberg,4539,5251,0,9790,4056,4752,94,8902,31611,0.07272727272727272,0.07901907356948229,Dem (Obama),Dem (Obama),6
texas,dallas,309477,424468,0,733945,294339,403170,8432,705941,2321014,0.15667522770779826,0.15602809426114933,Dem (Obama),Dem (Obama),10
texas,brazos,37403,20459,0,57862,37152,17440,1253,55845,185426,-0.2928346756074799,-0.36107854630715125,Rep (McCain),Rep (Romney),9
texas,sabine,3749,1077,0,4826,3726,806,40,4572,10653,-0.5536676336510568,-0.6443071491615181,Rep (McCain),Rep (Romney),3
texas,taylor,34265,12658,0,46923,32853,9725,592,43170,129477,-0.46047780406197386,-0.5431913194607544,Rep (McCain),Rep (Romney),9
texas,houston,5869,2653,0,8522,5839,2235,55,8129,23642,-0.377376202769303,-0.4463710676244736,Rep (McCain),Rep (Romney),5
texas,bexar,245932,275023,0,520955,240519,263871,7015,511405,1650052,0.05584167538463015,0.04629750788080652,Dem (Obama),Dem (Obama),10
texas,washington,10173,4031,0,14204,10850,3378,145,14373,32949,-0.4324134046747395,-0.5251616530784369,Rep (McCain),Rep (Romney),6
texas,sanjacinto,6151,2721,0,8872,7105,2410,95,9610,25859,-0.38660955816050496,-0.4934314240672622,Rep (McCain),Rep (Romney),5
texas,mitchell,1814,586,0,2400,1754,536,22,2312,9342,-0.5116666666666667,-0.5318777292576419,Rep (McCain),Rep (Romney),3
texas,victoria,19876,9829,0,29705,19684,8795,348,28827,85813,-0.33822588789766034,-0.38235190842375083,Rep (McCain),Rep (Romney),8
texas,panola,7582,2586,0,10168,7941,2211,69,10221,23569,-0.491345397324941,-0.5644208037825059,Rep (McCain),Rep (Romney),5
texas,armstrong,856,128,0,984,828,98,9,935,1958,-0.7398373983739838,-0.7883369330453563,Rep (McCain),Rep (Romney),1
texas,reagan,795,197,0,992,676,158,9,843,3298,-0.6028225806451613,-0.6211031175059952,Rep (McCain),Rep (Romney),1
texas,hudspeth,458,430,0,888,471,379,11,861,3441,-0.03153153153153153,-0.10823529411764705,Rep (McCain),Rep (Romney),1
texas,gaines,3385,650,0,4035,3484,535,47,4066,16658,-0.677819083023544,-0.7337646180641951,Rep (McCain),Rep (Romney),4
texas,throckmorton,671,166,0,837,700,109,4,813,1814,-0.6033452807646356,-0.73053152039555,Rep (McCain),Rep (Romney),1
texas,nolan,3485,1521,0,5006,3277,1216,74,4567,14990,-0.39232920495405516,-0.4587135544179835,Rep (McCain),Rep (Romney),4
texas,morris,3157,2054,0,5211,3226,1856,47,5129,13077,-0.2116676261753982,-0.2695789059425423,Rep (McCain),Rep (Romney),3
texas,glasscock,502,52,0,554,526,44,8,578,1317,-0.8122743682310469,-0.8456140350877193,Rep (McCain),Rep (Romney),1
texas,bell,49066,40185,0,89251,49369,35315,1081,85765,294689,-0.09950588788921133,-0.1659581502999386,Rep (McCain),Rep (Romney),10
texas,jasper,8960,3636,0,12596,9924,3402,140,13466,35248,-0.4226738647189584,-0.4894191805493021,Rep (McCain),Rep (Romney),6
texas,dallam,1267,302,0,1569,1248,253,31,1532,6471,-0.6150414276609305,-0.6628914057295137,Rep (McCain),Rep (Romney),2
texas,limestone,5062,2515,0,7577,5288,2208,67,7563,23170,-0.33614887158506007,-0.41088580576307365,Rep (McCain),Rep (Romney),5
texas,johnson,36683,12903,0,49586,37609,10481,663,48753,147611,-0.4795708466099302,-0.5641089623622375,Rep (McCain),Rep (Romney),9
texas,fayette,7572,3009,0,10581,8098,2311,125,10534,24175,-0.43124468386730935,-0.5559611874339514,Rep (McCain),Rep (Romney),5
texas,deafsmith,3456,1246,0,4702,3042,1239,28,4309,19054,-0.4700127605274351,-0.42116327960756833,Rep (McCain),Rep (Romney),4
texas,karnes,2658,1710,0,4368,2823,1324,33,4180,14880,-0.21703296703296704,-0.36146612008680973,Rep (McCain),Rep (Romney),4
texas,goliad,2298,1329,0,3627,2294,1127,31,3452,7161,-0.26716294458229944,-0.34112832505115465,Rep (McCain),Rep (Romney),2
texas,zavala,596,3263,0,3859,574,3042,37,3653,11658,0.6911116869655352,0.6825221238938053,Dem (Obama),Dem (Obama),3
texas,smith,54995,23628,0,78623,61858,22101,835,84794,203393,-0.39895450440710734,-0.47352874617372764,Rep (McCain),Rep (Romney),10
texas,winkler,1529,477,0,2006,1331,398,16,1745,6933,-0.5244267198404786,-0.5396182764603817,Rep (McCain),Rep (Romney),2
texas,lynn,1469,623,0,2092,1377,464,11,1852,5988,-0.4043977055449331,-0.4959261271048343,Rep (McCain),Rep (Romney),2
texas,crane,1119,319,0,1438,985,275,23,1283,4141,-0.5563282336578581,-0.5634920634920635,Rep (McCain),Rep (Romney),1
texas,wise,15967,4469,0,20436,17178,3219,295,20692,58054,-0.5626345664513603,-0.6843653478452714,Rep (McCain),Rep (Romney),8
texas,garza,1355,375,0,1730,1262,276,18,1556,6204,-0.5664739884393064,-0.6410923276983095,Rep (McCain),Rep (Romney),2
texas,grayson,31122,13892,0,45014,30907,10665,635,42207,119111,-0.38276980494957125,-0.4869142692196671,Rep (McCain),Rep (Romney),9
texas,hartley,1711,250,0,1961,1700,183,21,1904,5963,-0.7450280469148394,-0.8056293149229952,Rep (McCain),Rep (Romney),2
utah,utah,111273,26276,0,137549,142337,15791,3150,161278,486067,-0.6179397887298345,-0.8002757259941313,Rep (McCain),Rep (Romney),10
utah,sevier,6222,1320,0,7542,6961,701,119,7781,20438,-0.6499602227525855,-0.8170190550770033,Rep (McCain),Rep (Romney),5
utah,sanjuan,2586,2322,0,4908,3006,2062,91,5159,14299,-0.05378973105134474,-0.186266771902131,Rep (McCain),Rep (Romney),4
utah,carbon,3960,3368,0,7328,4834,2204,193,7231,20765,-0.08078602620087336,-0.3736857061665246,Rep (McCain),Rep (Romney),5
utah,beaver,1786,509,0,2295,2153,341,40,2534,6431,-0.5564270152505446,-0.7265437048917401,Rep (McCain),Rep (Romney),2
utah,tooele,10201,5349,0,15550,12240,3794,388,16422,55398,-0.3120257234726688,-0.5267556442559561,Rep (McCain),Rep (Romney),8
utah,cache,27799,9806,0,37605,30818,5434,847,37099,107078,-0.4784736072330807,-0.70020964360587,Rep (McCain),Rep (Romney),9
utah,piute,635,141,0,776,696,74,11,781,1661,-0.6365979381443299,-0.8077922077922078,Rep (McCain),Rep (Romney),1
utah,millard,3565,733,0,4298,4421,424,113,4958,12189,-0.65891112145183806,-0.8249742002063983,Rep (McCain),Rep (Romney),3
utah,iron,11786,3078,0,14864,11172,1720,276,13168,44439,-0.5858449946178687,-0.7331678560347502,Rep (McCain),Rep (Romney),7
utah,rich,829,154,0,983,907,83,9,999,2181,-0.6866734486266531,-0.8323232323232324,Rep (McCain),Rep (Romney),1
utah,kane,2194,850,0,3044,2463,718,100,3281,6893,-0.44152431011826543,-0.5485696321911349,Rep (McCain),Rep (Romney),2
utah,grand,1787,1981,0,3768,1917,1678,217,3812,8987,0.05148619957537155,-0.06648122392211404,Dem (Obama),Rep (Romney),2
utah,emery,3338,965,0,4303,3743,569,102,4414,10728,-0.5514757146177086,-0.7360853432282004,Rep (McCain),Rep (Romney),3
utah,sanpete,6036,1449,0,7485,7767,889,148,8804,26651,-0.6128256513026052,-0.7945933456561922,Rep (McCain),Rep (Romney),6
utah,juab,2647,730,0,3377,3400,436,71,3907,9855,-0.5676636067515546,-0.7726798748696558,Rep (McCain),Rep (Romney),3
utah,washington,33594,9251,0,42845,41104,7762,867,49733,134033,-0.5681643132220796,-0.6823149019768346,Rep (McCain),Rep (Romney),9
utah,saltlake,163579,161696,0,325275,198739,132686,10239,341664,1000155,-0.0057889478133886715,-0.19929999245681526,Rep (McCain),Rep (Romney),10
utah,duchesne,4592,897,0,5489,5608,570,95,6273,17408,-0.6731645108398615,-0.8154742635157008,Rep (McCain),Rep (Romney),4
utah,wasatch,5271,2818,0,8089,6852,2097,160,9109,22176,-0.30325132896526147,-0.531344284277573,Rep (McCain),Rep (Romney),5
utah,davis,73317,28831,0,102148,90030,20417,2121,112568,294532,-0.4355053451854172,-0.6302842087154925,Rep (McCain),Rep (Romney),10
utah,garfield,1663,402,0,2065,1811,306,40,2157,4958,-0.6106537530266344,-0.7109116674539443,Rep (McCain),Rep (Romney),1
utah,morgan,3219,674,0,3893,3910,386,74,4370,9013,-0.6537374775237605,-0.8202979515828678,Rep (McCain),Rep (Romney),2
utah,weber,43250,24028,0,67278,48938,17569,1636,68143,222849,-0.28571003894289365,-0.4716646368051483,Rep (McCain),Rep (Romney),10
utah,wayne,930,333,0,1263,1087,213,23,1323,2706,-0.47268408551068886,-0.6723076923076923,Rep (McCain),Rep (Romney),1
utah,boxelder,14340,3080,0,17420,15969,1830,293,18092,48221,-0.6463834672789897,-0.7943704702511377,Rep (McCain),Rep (Romney),7
utah,daggett,294,129,0,423,399,91,19,509,839,-0.3900709219858156,-0.6285714285714286,Rep (McCain),Rep (Romney),1
utah,summit,6691,9194,0,15885,8464,7656,496,16616,35295,0.157570034623859,-0.05012406947890819,Dem (Obama),Rep (Romney),6
utah,uintah,8113,1407,0,9520,10001,962,153,11116,30991,-0.7044117647058824,-0.8245005929034024,Rep (McCain),Rep (Romney),6
vermont,addison,5112,12311,0,17423,5214,12290,339,17843,36841,0.41318946220513114,0.40425045703839124,Dem (Obama),Dem (Obama),7
vermont,chittenden,19685,43886,0,63571,21567,53615,1349,76531,154729,0.38069245410643215,0.4262722460163337,Dem (Obama),Dem (Obama),9
vermont,orange,5043,9777,0,14820,4588,9075,301,13964,29059,0.3194331983805668,0.32840518187806483,Dem (Obama),Dem (Obama),6
vermont,grandisle,1490,2694,0,4184,1471,2531,62,4064,7105,0.28776290630975143,0.26486756621689156,Dem (Obama),Dem (Obama),2
vermont,bennington,6116,12523,0,18639,5687,11517,308,17512,37122,0.34374161703954076,0.3388746803069054,Dem (Obama),Dem (Obama),7
vermont,caledonia,5470,8899,0,14369,5088,8192,265,13545,31214,0.23863873616813974,0.23373493975903614,Dem (Obama),Dem (Obama),6
vermont,washington,9120,22304,0,31424,8092,20349,608,29049,59379,0.4195519348268839,0.4309623430962343,Dem (Obama),Dem (Obama),8
vermont,lamoille,3515,8914,0,12429,3352,8371,201,11924,24040,0.43438731997747204,0.4281327305297279,Dem (Obama),Dem (Obama),5
vermont,rutland,11582,19340,0,30922,10834,17087,493,28414,62278,0.25088933445443373,0.2239532968016905,Dem (Obama),Dem (Obama),8
vermont,windham,5703,17102,0,22805,5344,16080,381,21805,44438,0.4998465248848937,0.5011202389843167,Dem (Obama),Dem (Obama),7
vermont,orleans,4478,7992,0,12470,4306,7116,209,11631,27256,0.2817963111467522,0.2460164594641919,Dem (Obama),Dem (Obama),6
vermont,windsor,9072,21424,0,30496,8583,19440,445,28468,56891,0.4050367261280168,0.3874317524890269,Dem (Obama),Dem (Obama),8
vermont,franklin,7853,13180,0,21033,7405,12057,293,19755,47547,0.2532686730376076,0.23902990442914399,Dem (Obama),Dem (Obama),7
vermont,essex,1183,1653,0,2836,1169,1539,61,2769,6359,0.16572637517630465,0.13663220088626293,Dem (Obama),Dem (Obama),2
virginia,virginiabeachcity,89229,83856,0,173085,99107,94163,2553,195823,435996,-0.031042551347603777,-0.02558079370828375,Rep (McCain),Rep (Romney),10
virginia,rockbridge,5732,4347,0,10079,5898,4087,170,10155,22217,-0.1374144260343288,-0.1813720580871307,Rep (McCain),Rep (Romney),5
virginia,fairfax,167057,240175,0,407232,173786,260835,5553,440174,1048554,0.1795487584472733,0.20028714673244044,Dem (Obama),Dem (Obama),10
virginia,middlesex,3545,2390,0,5935,3619,2370,78,6067,10831,-0.1946082561078349,-0.20854900651193856,Rep (McCain),Rep (Romney),3
virginia,richmond,2092,1614,0,3706,2160,1574,34,3768,9328,-0.12898003237992445,-0.1569362613818961,Rep (McCain),Rep (Romney),3
virginia,botetourt,11466,5690,0,17156,12471,5449,288,18208,32867,-0.33667521566798786,-0.3918526785714286,Rep (McCain),Rep (Romney),6
virginia,york,17781,11650,0,29431,20182,13165,501,33848,64846,-0.2083177601848391,-0.21042372627222838,Rep (McCain),Rep (Romney),8
virginia,lynchburgcity,17622,16256,0,33878,19752,15905,585,36242,73726,-0.04032115237026979,-0.10788905404268447,Rep (McCain),Rep (Romney),8
virginia,accomack,7766,7696,0,15462,8212,7653,155,16020,34066,-0.004527228042943992,-0.03523479357075323,Rep (McCain),Rep (Romney),6
virginia,nottoway,3437,3358,0,6795,3409,3344,91,6844,15819,-0.011626195732155998,-0.009625351695542721,Rep (McCain),Rep (Romney),4
virginia,bedford,24402,11007,0,35409,29281,10925,544,40750,67697,-0.37829365415572314,-0.4565487738148535,Rep (McCain),Rep (Romney),8
virginia,brunswick,2690,4772,0,7462,2965,4993,71,8029,17707,0.2790136692575717,0.25483789896959036,Dem (Obama),Dem (Obama),4
virginia,dickenson,3293,3253,0,6546,4274,2472,132,6878,15966,-0.006110601894286587,-0.2671212570412096,Rep (McCain),Rep (Romney),4
virginia,russell,6387,4928,0,11315,8177,3716,170,12063,28842,-0.12894387980556782,-0.37509459345833684,Rep (McCain),Rep (Romney),6
virginia,orange,8492,7095,0,15587,9244,6870,216,16330,32730,-0.08962597035991532,-0.14732530718629763,Rep (McCain),Rep (Romney),6
virginia,southampton,4583,4402,0,8985,4733,4437,91,9261,18493,-0.020144685587089595,-0.03227917121046892,Rep (McCain),Rep (Romney),4
virginia,nelson,3646,4383,0,8029,3944,4171,110,8225,14989,0.09179225308257566,0.027972889710412816,Dem (Obama),Dem (Obama),4
virginia,appomattox,4903,2639,0,7542,5340,2453,131,7924,14653,-0.3001856271546009,-0.3704606698319004,Rep (McCain),Rep (Romney),4
virginia,roanoke,30171,19469,0,49640,33344,19589,860,53793,91583,-0.21559226430298148,-0.2598568001057941,Rep (McCain),Rep (Romney),9
virginia,fluvanna,6414,6173,0,12587,6678,5885,161,12724,25308,-0.019146738698657344,-0.06312186579638622,Rep (McCain),Rep (Romney),5
virginia,madison,3758,2862,0,6620,3864,2637,96,6597,13342,-0.13534743202416918,-0.18874019381633594,Rep (McCain),Rep (Romney),3
virginia,augusta,23111,9821,0,32932,23614,9448,552,33614,73201,-0.40355884853637797,-0.4284677273002238,Rep (McCain),Rep (Romney),8
virginia,lancaster,3644,3232,0,6876,3749,3144,159,7052,11478,-0.05991855730075625,-0.08777020165385173,Rep (McCain),Rep (Romney),3
virginia,poquosoncity,5229,1747,0,6976,5312,1679,107,7098,12099,-0.49913990825688076,-0.5196681447575454,Rep (McCain),Rep (Romney),3
virginia,kingandqueen,1763,1917,0,3680,1863,1743,39,3645,6926,0.04184782608695652,-0.033277870216306155,Dem (Obama),Rep (Romney),2
virginia,smyth,7813,4230,0,12043,8376,4169,206,12751,32383,-0.29751722992609814,-0.335352730171383,Rep (McCain),Rep (Romney),6
virginia,harrisonburgcity,5556,7687,0,13243,6564,8650,327,15541,47406,0.16091520048327418,0.1371105560667806,Dem (Obama),Dem (Obama),7
virginia,craig,1695,876,0,2571,1757,830,77,2664,5173,-0.3185530921820303,-0.3583301120989563,Rep (McCain),Rep (Romney),1
virginia,buchanan,4538,4055,0,8593,6436,3094,106,9636,24459,-0.056208541836378446,-0.35068205666316893,Rep (McCain),Rep (Romney),5
virginia,buenavistacity,1282,1108,0,2390,1564,919,43,2526,6653,-0.07280334728033473,-0.2597664115988723,Rep (McCain),Rep (Romney),2
virginia,franklincity,1574,2815,0,4389,1496,2830,25,4351,8549,0.2827523353839143,0.3083680073971336,Dem (Obama),Dem (Obama),2
virginia,lee,5827,3212,0,9039,6845,2593,150,9588,25434,-0.28930191392853194,-0.4505191777919051,Rep (McCain),Rep (Romney),5
virginia,manassascity,5129,6114,0,11243,6463,8478,213,15154,36067,0.08761006848705861,0.1348637976039087,Dem (Obama),Dem (Obama),6
virginia,hamptoncity,18808,38846,0,57654,19193,51733,787,71713,139046,0.3475561105907656,0.458788032597355,Dem (Obama),Dem (Obama),9
virginia,princegeorge,7750,7190,0,14940,9350,7671,159,17180,35129,-0.03748326639892905,-0.09864285294636038,Rep (McCain),Rep (Romney),6
virginia,covingtoncity,1020,1304,0,2324,975,1319,35,2329,5989,0.12220309810671257,0.14995640802092414,Dem (Obama),Dem (Obama),2
virginia,fallschurchcity,1967,4693,0,6660,2141,5006,97,7244,11465,0.4093093093093093,0.40086749685182593,Dem (Obama),Dem (Obama),3
virginia,culpeper,10701,8782,0,19483,11549,8263,319,20131,45749,-0.09849612482677206,-0.1658590753078942,Rep (McCain),Rep (Romney),7
virginia,kinggeorge,5885,4471,0,10356,6603,4476,208,11287,22794,-0.1365392043259946,-0.19198483617655024,Rep (McCain),Rep (Romney),5
virginia,rockingham,22459,10533,0,32992,24173,10059,551,34783,74922,-0.3614815712900097,-0.41230427670016356,Rep (McCain),Rep (Romney),8
virginia,danvillecity,8359,12342,0,20701,7756,12215,198,20169,43787,0.1924061639534322,0.22327374693305294,Dem (Obama),Dem (Obama),7
virginia,richmondcity,18472,73180,0,91652,19732,71037,1406,92175,201828,0.5969100510627154,0.5652260132864745,Dem (Obama),Dem (Obama),10
virginia,portsmouthcity,12760,26200,0,38960,12407,28994,459,41860,96785,0.34496919917864477,0.4006424965580542,Dem (Obama),Dem (Obama),9
virginia,mecklenburg,7809,7124,0,14933,7855,6786,172,14813,32774,-0.045871559633027525,-0.07301413837852605,Rep (McCain),Rep (Romney),6
virginia,charlotte,3371,2702,0,6073,3311,2502,84,5897,12644,-0.11015972336571711,-0.13917082401513847,Rep (McCain),Rep (Romney),3
virginia,emporiacity,897,1702,0,2599,886,1793,12,2691,5822,0.30973451327433627,0.3385591638671146,Dem (Obama),Dem (Obama),2
virginia,alexandriacity,19140,50415,0,69555,20205,52434,831,73470,133647,0.44964416648695277,0.44368727543055386,Dem (Obama),Dem (Obama),9
virginia,greensville,1729,3121,0,4850,1766,3135,24,4925,12181,0.28701030927835053,0.27933074882677006,Dem (Obama),Dem (Obama),3
virginia,hanover,37244,18443,0,55687,39920,18283,733,58936,99172,-0.3376191929893871,-0.37175059704826213,Rep (McCain),Rep (Romney),9
virginia,highland,929,590,0,1519,924,459,28,1411,2395,-0.22317314022383147,-0.3362255965292842,Rep (McCain),Rep (Romney),1
virginia,warren,8878,6994,0,15872,9865,6449,322,16636,37044,-0.11869959677419355,-0.20939070736790485,Rep (McCain),Rep (Romney),7
virginia,surry,1662,2623,0,4285,1671,2574,57,4302,7039,0.22427071178529756,0.2127208480565371,Dem (Obama),Dem (Obama),2
virginia,dinwiddie,6521,6244,0,12765,6769,6425,145,13339,27449,-0.021699960830395614,-0.026072457177504928,Rep (McCain),Rep (Romney),6
virginia,bland,2030,864,0,2894,2144,735,58,2937,6873,-0.4029025570145128,-0.48940604376519625,Rep (McCain),Rep (Romney),2
virginia,westmoreland,3718,4576,0,8294,4116,4155,418,8689,17237,0.10344827586206896,0.004715270221254987,Dem (Obama),Dem (Obama),4
virginia,page,5992,4302,0,10294,6344,3724,137,10205,24116,-0.16417330483776957,-0.2602304330552245,Rep (McCain),Rep (Romney),5
virginia,albemarle,21009,31068,0,52077,23263,29712,757,53732,96633,0.19315628780459704,0.12173666823973572,Dem (Obama),Dem (Obama),9
virginia,bristolcity,4576,2662,0,7238,4776,2487,93,7356,17704,-0.26443768996960487,-0.3151590251961999,Rep (McCain),Rep (Romney),4
virginia,campbell,17353,8027,0,25380,17687,7591,354,25632,54174,-0.36745468873128445,-0.3993986866049529,Rep (McCain),Rep (Romney),8
virginia,alleghany,3515,3308,0,6823,3595,3403,164,7162,16406,-0.03033856075040305,-0.02743641040297228,Rep (McCain),Rep (Romney),4
virginia,colonialheightscity,6160,2557,0,8717,5937,2541,115,8593,17472,-0.4133302741768957,-0.4005661712668082,Rep (McCain),Rep (Romney),4
virginia,sussex,2029,3195,0,5224,2021,3350,50,5421,12167,0.22320061255742726,0.2474399553155837,Dem (Obama),Dem (Obama),3
virginia,newportnewscity,26355,45429,0,71784,27224,50990,955,79169,181822,0.2657138080909395,0.30385864423249037,Dem (Obama),Dem (Obama),9
virginia,rappahannock,2227,2105,0,4332,2307,1971,53,4331,7376,-0.02816251154201293,-0.0785413744740533,Rep (McCain),Rep (Romney),2
virginia,scott,6372,2473,0,8845,7439,2395,130,9964,23234,-0.44081401921989827,-0.5129143786861907,Rep (McCain),Rep (Romney),5
virginia,radfordcity,2418,2930,0,5348,2520,2732,130,5382,16318,0.09573672400897532,0.04036557501904037,Dem (Obama),Dem (Obama),4
virginia,goochland,7640,4812,0,12452,8448,4676,163,13287,21136,-0.22711211050433666,-0.2874123742761353,Rep (McCain),Rep (Romney),5
virginia,lexingtoncity,914,1540,0,2454,1146,1484,47,2677,6990,0.25509372453137735,0.1285171102661597,Dem (Obama),Dem (Obama),2
virginia,norfolkcity,22726,56191,0,78917,21366,55654,905,77925,242143,0.42405311909981375,0.44518306933264085,Dem (Obama),Dem (Obama),10
virginia,suffolkcity,15630,19193,0,34823,17778,24194,409,42381,82544,0.10231743387990695,0.1528638139712189,Dem (Obama),Dem (Obama),8
virginia,princeedward,4174,5099,0,9273,3952,5132,140,9224,22723,0.09975196807937022,0.12989872302950242,Dem (Obama),Dem (Obama),5
virginia,mathews,3454,1943,0,5397,3488,1807,69,5364,9004,-0.279970353900315,-0.3174693106704438,Rep (McCain),Rep (Romney),2
virginia,nortoncity,744,742,0,1486,895,566,25,1486,3886,-0.0013458950201884253,-0.22518822724161533,Rep (McCain),Rep (Romney),1
virginia,powhatan,10084,4233,0,14317,11192,4066,208,15466,27758,-0.4086750017461759,-0.4670336872460349,Rep (McCain),Rep (Romney),6
virginia,buckingham,3427,3493,0,6920,3569,3747,131,7447,16874,0.00953757225433526,0.02433023510114817,Dem (Obama),Dem (Obama),4
virginia,amelia,3964,2479,0,6443,4324,2488,73,6885,12517,-0.23048269439702002,-0.26952436876101,Rep (McCain),Rep (Romney),3
virginia,fairfaxcity,4686,6571,0,11257,4762,6636,179,11577,22058,0.16745136359598473,0.16441480961572205,Dem (Obama),Dem (Obama),5
virginia,loudoun,55428,62560,0,117988,74794,81900,1954,158648,291653,0.060446825100857714,0.04534953476202024,Dem (Obama),Dem (Obama),10
virginia,arlington,29704,78958,0,108662,34433,81178,1668,117279,197467,0.45327713460087243,0.40433003779917137,Dem (Obama),Dem (Obama),10
virginia,williamsburgcity,2350,4322,0,6672,2678,4901,143,7722,13421,0.29556354916067146,0.2933104631217839,Dem (Obama),Dem (Obama),3
virginia,patrick,5489,2879,0,8368,5622,2417,202,8241,18643,-0.31190248565965584,-0.39868142803831325,Rep (McCain),Rep (Romney),4
virginia,henry,13757,11116,0,24873,13980,10312,635,24927,54860,-0.10617939130784385,-0.1509962127449366,Rep (McCain),Rep (Romney),8
virginia,wythe,8197,4099,0,12296,8324,3782,230,12336,29005,-0.33327911515940145,-0.3751858582521064,Rep (McCain),Rep (Romney),6
virginia,charlottesvillecity,3908,14862,0,18770,4801,16267,387,21455,42267,0.5835908364411294,0.5442377064742738,Dem (Obama),Dem (Obama),7
virginia,fauquier,19224,14614,0,33838,20955,13891,493,35339,64546,-0.1362373662746025,-0.20272054181254665,Rep (McCain),Rep (Romney),8
virginia,caroline,5461,6908,0,12369,6148,7258,184,13590,27844,0.11698601342064839,0.08279874682977771,Dem (Obama),Dem (Obama),6
virginia,roanokecity,14131,22623,0,36754,14116,22179,1184,37479,95793,0.23104968166730153,0.22215181154428984,Dem (Obama),Dem (Obama),9
virginia,pulaski,8855,5917,0,14772,8917,5287,453,14657,34963,-0.19888979149742755,-0.2555618135736412,Rep (McCain),Rep (Romney),6
virginia,floyd,4441,2937,0,7378,4671,2732,223,7626,15030,-0.20384928164814312,-0.2619208429015264,Rep (McCain),Rep (Romney),4
virginia,charlescity,1288,2811,0,4099,1396,2772,45,4213,7205,0.37155403757013905,0.33013435700575816,Dem (Obama),Dem (Obama),2
virginia,cumberland,2418,2255,0,4673,2538,2422,80,5040,9855,-0.034881232612882514,-0.02338709677419355,Rep (McCain),Rep (Romney),3
virginia,tazewell,11196,5592,0,16788,13843,3661,208,17712,44706,-0.33380986418870623,-0.5816956124314442,Rep (McCain),Rep (Romney),7
virginia,clarke,3839,3456,0,7295,4295,3237,199,7731,14013,-0.052501713502398906,-0.1404673393520977,Rep (McCain),Rep (Romney),4
virginia,gloucester,11737,6722,0,18459,12137,6764,345,19246,36610,-0.27168318977192696,-0.28427067350933816,Rep (McCain),Rep (Romney),7
virginia,halifax,8591,8107,0,16698,8699,7760,204,16663,36311,-0.028985507246376812,-0.0570508536363084,Rep (McCain),Rep (Romney),6
virginia,northampton,2711,3795,0,6506,2676,3737,68,6481,12572,0.16661543190900707,0.1654451894589116,Dem (Obama),Dem (Obama),3
virginia,franklin,15414,9618,0,25032,16685,9082,866,26633,54938,-0.23154362416107382,-0.2950673341871386,Rep (McCain),Rep (Romney),8
virginia,montgomery,17822,19139,0,36961,20006,19903,1029,40938,92527,0.035632152809718355,-0.0025808714826229674,Dem (Obama),Rep (Romney),9
virginia,amherst,8469,6083,0,14552,8865,5898,174,14937,32315,-0.16396371632765255,-0.2009754115017273,Rep (McCain),Rep (Romney),6
virginia,galaxcity,1316,1052,0,2368,1332,900,41,2273,6936,-0.11148648648648649,-0.1935483870967742,Rep (McCain),Rep (Romney),2
virginia,newkent,6285,3490,0,9775,7246,3555,140,10941,17655,-0.28593350383631716,-0.34172761781316546,Rep (McCain),Rep (Romney),4
virginia,fredericksburgcity,3381,6081,0,9462,4054,7114,228,11396,23375,0.2853519340519975,0.2739971346704871,Dem (Obama),Dem (Obama),5
virginia,chesterfield,86318,74169,0,160487,91174,78954,2095,172223,308633,-0.07570083558169821,-0.07182827047869839,Rep (McCain),Rep (Romney),10
virginia,greene,4978,3272,0,8250,5558,3284,151,8993,18082,-0.2067878787878788,-0.25718163311467995,Rep (McCain),Rep (Romney),4
virginia,kingwilliam,4966,3344,0,8310,5445,3326,94,8865,15509,-0.19518652226233454,-0.24159160871052332,Rep (McCain),Rep (Romney),4
virginia,manassascitypark,1634,2460,0,4094,1696,2873,58,4627,13195,0.20175867122618465,0.2576056029765813,Dem (Obama),Dem (Obama),3
virginia,petersburgcity,1582,13671,0,15253,1526,14377,74,15977,32303,0.7925653969710876,0.8080865245551154,Dem (Obama),Dem (Obama),6
virginia,pittsylvania,18418,11394,0,29812,19275,10855,448,30578,63147,-0.2356098215483698,-0.2794556920013276,Rep (McCain),Rep (Romney),8
virginia,lunenburg,2900,2702,0,5602,2969,2684,73,5726,12968,-0.035344519814352014,-0.050415708473376966,Rep (McCain),Rep (Romney),3
virginia,jamescity,20779,17218,0,37997,22830,17854,450,41134,64386,-0.09371792509934995,-0.12230852423557172,Rep (McCain),Rep (Romney),8
virginia,stauntoncity,5328,5570,0,10898,5257,5710,187,11154,23806,0.022205909341163517,0.04130573538798213,Dem (Obama),Dem (Obama),5
virginia,salemcity,7083,5160,0,12243,7289,4756,225,12270,24641,-0.15706934574859102,-0.21029472810294728,Rep (McCain),Rep (Romney),5
virginia,carroll,8187,4109,0,12296,8351,3500,464,12315,29985,-0.3316525699414444,-0.40933254577672773,Rep (McCain),Rep (Romney),6
virginia,frederick,20148,12949,0,33097,22851,12683,738,36272,75835,-0.21751216122307157,-0.2861484775144932,Rep (McCain),Rep (Romney),8
virginia,princewilliam,57177,73585,0,130762,74371,103161,2116,179648,379415,0.12547987947568864,0.16216794718698602,Dem (Obama),Dem (Obama),10
virginia,stafford,29207,25704,0,54911,32429,27130,779,60338,124587,-0.06379413960772887,-0.08897060058093655,Rep (McCain),Rep (Romney),9
virginia,waynesborocity,4815,3905,0,8720,4789,3836,147,8772,20885,-0.10435779816513761,-0.1104927536231884,Rep (McCain),Rep (Romney),5
virginia,washington,16055,8052,0,24107,18141,7076,365,25582,54322,-0.33197826357489524,-0.4387912915890074,Rep (McCain),Rep (Romney),8
virginia,henrico,67265,86063,0,153328,70235,89116,1844,161195,300053,0.12259991651883544,0.11848686233534775,Dem (Obama),Dem (Obama),10
virginia,spotsylvania,28606,24893,0,53499,31818,25150,829,57797,120212,-0.0694031664143255,-0.1170481673922202,Rep (McCain),Rep (Romney),9
virginia,northumberland,4036,3304,0,7340,4308,3186,48,7542,12419,-0.0997275204359673,-0.14971977582065651,Rep (McCain),Rep (Romney),3
virginia,bath,1349,1043,0,2392,1274,894,50,2218,4779,-0.12792642140468227,-0.1752767527675277,Rep (McCain),Rep (Romney),1
virginia,winchestercity,4722,5266,0,9988,4943,5089,222,10254,25953,0.05446535843011614,0.014553429027113238,Dem (Obama),Dem (Obama),6
virginia,isleofwight,11253,8569,0,19822,11797,8754,221,20772,34762,-0.13540510543840178,-0.14807065349618023,Rep (McCain),Rep (Romney),6
virginia,bedfordcity,1497,1208,0,2705,1527,1225,46,2798,6177,-0.10683918669131238,-0.10973837209302326,Rep (McCain),Rep (Romney),2
virginia,chesapeakecity,47539,45917,0,93456,53845,54999,1261,110105,219268,-0.017355760999828797,0.010602329940097754,Rep (McCain),Dem (Obama),10
virginia,shenandoah,12005,6903,0,18908,12526,6462,301,19289,41468,-0.2698328749735562,-0.3193595955340215,Rep (McCain),Rep (Romney),7
virginia,hopewellcity,4149,5285,0,9434,3737,5178,96,9011,22506,0.12041551833792664,0.16163768928771732,Dem (Obama),Dem (Obama),5
virginia,louisa,8155,6938,0,15093,9207,6949,248,16404,32248,-0.08063340621480157,-0.13976231740529835,Rep (McCain),Rep (Romney),6
virginia,martinsvillecity,2309,4134,0,6443,2312,3855,110,6277,14029,0.2832531429458327,0.2502026917463921,Dem (Obama),Dem (Obama),4
virginia,wise,8902,4992,0,13894,11041,3751,145,14937,41496,-0.2814164387505398,-0.49283396430502974,Rep (McCain),Rep (Romney),7
virginia,essex,2377,2923,0,5300,2602,3009,55,5666,10901,0.1030188679245283,0.07253608982356086,Dem (Obama),Dem (Obama),3
virginia,giles,4462,3204,0,7666,4660,2730,154,7544,17205,-0.16410122619358206,-0.26116373477672533,Rep (McCain),Rep (Romney),4
virginia,grayson,4540,2480,0,7020,4801,2094,251,7146,15855,-0.2934472934472934,-0.39260333575054385,Rep (McCain),Rep (Romney),4
washington,sanjuan,2274,5729,0,8003,3061,6943,341,10345,15551,0.43171310758465575,0.38804478208716514,Dem (Obama),Dem (Obama),4
washington,king,119823,317783,0,437606,254293,605247,20103,879643,1879189,0.4523703971152132,0.4083044419107895,Dem (Obama),Dem (Obama),10
washington,douglas,4617,3119,0,7736,9287,5047,344,14678,37160,-0.19364012409513962,-0.29580019533975166,Rep (McCain),Rep (Romney),7
washington,kittitas,6829,5841,0,12670,8372,6462,318,15152,39869,-0.07797947908445146,-0.12875825805581773,Rep (McCain),Rep (Romney),7
washington,wahkiakum,1100,1112,0,2212,1115,1091,79,2285,3982,0.0054249547920434,-0.010879419764279238,Dem (Obama),Rep (Romney),1
washington,graysharbor,7737,11332,0,19069,11743,15692,789,28224,72092,0.1885258797000367,0.14394022234372153,Dem (Obama),Dem (Obama),8
washington,pacific,3989,5534,0,9523,4484,5684,309,10477,21192,0.16223879029717525,0.11801730920535011,Dem (Obama),Dem (Obama),5
washington,lewis,12164,9006,0,21170,15954,9772,622,26348,74650,-0.14917335852621635,-0.24030164036383425,Rep (McCain),Rep (Romney),8
washington,skamania,2495,2773,0,5268,2624,2554,148,5326,10869,0.052771450265755505,-0.013518733101583623,Dem (Obama),Rep (Romney),3
washington,stevens,6652,4842,0,11494,11655,6521,527,18703,43171,-0.15747346441621715,-0.2824603873239437,Rep (McCain),Rep (Romney),7
washington,kitsap,33481,45023,0,78504,48454,61187,2855,112496,247336,0.14702435544685621,0.11613356317435995,Dem (Obama),Dem (Obama),10
washington,grant,14217,8068,0,22285,17677,8834,739,27250,85142,-0.2759255104330267,-0.33355965448304475,Rep (McCain),Rep (Romney),8
washington,columbia,1447,667,0,2114,1545,634,43,2222,3957,-0.36896877956480606,-0.41808168884809543,Rep (McCain),Rep (Romney),1
washington,clallam,10679,12738,0,23417,18273,18383,1031,37687,70638,0.08792757398471196,0.0030008729812309037,Dem (Obama),Dem (Obama),8
washington,yakima,27651,22565,0,50216,38414,28761,1291,68466,236542,-0.10128245977377728,-0.14369929289170078,Rep (McCain),Rep (Romney),10
washington,spokane,81630,81847,0,163477,109754,96781,5751,212286,461262,0.001327403854976541,-0.06281259834894812,Dem (Obama),Rep (Romney),10
washington,asotin,4873,3822,0,8695,5647,3993,243,9883,21363,-0.12087406555491662,-0.17157676348547718,Rep (McCain),Rep (Romney),5
washington,whitman,4778,5208,0,9986,7460,6910,481,14851,43747,0.04306028439815742,-0.038274182324286705,Dem (Obama),Rep (Romney),7
washington,cowlitz,8670,12944,0,21614,20538,22507,1128,44173,101244,0.19774220412695476,0.04574282727378325,Dem (Obama),Dem (Obama),9
washington,adams,2085,972,0,3057,3111,1516,80,4707,17884,-0.36408243375858684,-0.3447157985735898,Rep (McCain),Rep (Romney),4
washington,island,13843,16658,0,30501,19251,21080,988,41319,78633,0.092292055998164,0.045349730976172176,Dem (Obama),Dem (Obama),8
washington,klickitat,3083,3252,0,6335,5138,4373,350,9861,20055,0.026677190213101814,-0.08043318263063821,Dem (Obama),Rep (Romney),5
washington,whatcom,19340,31274,0,50614,38764,49743,2651,91158,195993,0.23578456553522742,0.12404668557289254,Dem (Obama),Dem (Obama),10
washington,thurston,35231,58132,0,93363,43703,64879,3070,111652,243563,0.24528988999925025,0.19502311617026763,Dem (Obama),Dem (Obama),10
washington,mason,9456,11813,0,21269,12637,14568,692,27897,59287,0.11081856222671493,0.07097959933835692,Dem (Obama),Dem (Obama),8
washington,pendoreille,3325,2339,0,5664,3942,2501,206,6649,12904,-0.1740819209039548,-0.2236535775259972,Rep (McCain),Rep (Romney),3
washington,jefferson,4844,10656,0,15500,6113,11985,619,18717,29574,0.3749677419354839,0.32445574096585256,Dem (Obama),Dem (Obama),6
washington,benton,28742,17452,0,46194,49105,27846,1923,78874,167077,-0.2444040351560809,-0.27626671518238877,Rep (McCain),Rep (Romney),9
washington,garfield,876,353,0,1229,912,335,28,1275,2240,-0.4255492270138324,-0.46271050521251,Rep (McCain),Rep (Romney),1
washington,wallawalla,8712,6209,0,14921,11057,7083,437,18577,57585,-0.1677501507941827,-0.21907386990077177,Rep (McCain),Rep (Romney),8
washington,ferry,1817,1386,0,3203,1966,1276,149,3391,7504,-0.13456134873556042,-0.21283158544108574,Rep (McCain),Rep (Romney),2
washington,skagit,16146,20604,0,36750,21930,24860,1199,47989,115231,0.12130612244897959,0.06262021799529814,Dem (Obama),Dem (Obama),9
washington,chelan,13946,11173,0,25119,18237,12938,724,31899,70995,-0.11039452207492337,-0.16997594226142743,Rep (McCain),Rep (Romney),8
washington,snohomish,62363,102532,0,164895,123948,173695,7381,305024,694219,0.24360350526092361,0.16713646885698638,Dem (Obama),Dem (Obama),10
washington,franklin,7789,4843,0,12632,11912,7332,431,19675,71329,-0.2332172260924636,-0.237996258574101,Rep (McCain),Rep (Romney),8
washington,okanogan,5100,4736,0,9836,7151,5259,371,12781,40238,-0.03700691337942253,-0.15245769540692988,Rep (McCain),Rep (Romney),7
washington,lincoln,3049,1708,0,4757,4024,1649,131,5804,10533,-0.2819003573680891,-0.41864974440331393,Rep (McCain),Rep (Romney),3
washington,pierce,53601,75571,0,129172,147422,184694,7911,340027,782681,0.1700832997863314,0.11222584879981694,Dem (Obama),Dem (Obama),10
washington,clark,63042,75433,0,138475,89696,89817,4215,183728,414816,0.08948185593067341,6.740458908268482e-4,Dem (Obama),Dem (Obama),10
west virginia,wirt,1482,777,0,2259,1422,673,68,2163,5753,-0.31208499335989376,-0.3575178997613365,Rep (McCain),Rep (Romney),2
west virginia,webster,1374,1543,0,2917,1708,939,97,2744,9247,0.057936235858759,-0.29051756705704573,Dem (Obama),Rep (Romney),2
west virginia,hardy,3360,1880,0,5240,3523,1477,149,5149,13832,-0.2824427480916031,-0.4092,Rep (McCain),Rep (Romney),3
west virginia,pendleton,1605,1049,0,2654,2087,1067,70,3224,7773,-0.20949510173323285,-0.3233988585922638,Rep (McCain),Rep (Romney),2
west virginia,nicholas,6115,6007,0,12122,5823,2635,218,8676,26189,-0.008909420887642303,-0.37692125798061005,Rep (McCain),Rep (Romney),6
west virginia,hancock,7257,5285,0,12542,7159,4571,261,11991,30866,-0.15723170148301707,-0.2206308610400682,Rep (McCain),Rep (Romney),6
west virginia,boone,3603,4490,0,8093,5414,2777,243,8434,24872,0.1096008896577289,-0.3219387132218288,Dem (Obama),Rep (Romney),5
west virginia,mcdowell,2852,3410,0,6262,3931,2086,119,6136,22555,0.0891089108910891,-0.30663121156722617,Dem (Obama),Rep (Romney),5
west virginia,summers,2875,2276,0,5151,2968,1612,132,4712,13847,-0.11628809939817511,-0.2960698689956332,Rep (McCain),Rep (Romney),4
west virginia,marion,11389,11507,0,22896,11981,8905,528,21414,56356,0.005153738644304682,-0.14727568706310448,Dem (Obama),Rep (Romney),8
west virginia,pleasants,1753,1127,0,2880,1805,942,60,2807,7664,-0.21736111111111112,-0.31416090280305786,Rep (McCain),Rep (Romney),2
west virginia,lewis,4312,2096,0,6408,4349,1719,175,6243,16406,-0.34581772784019976,-0.43342122610415296,Rep (McCain),Rep (Romney),4
west virginia,tyler,2390,1234,0,3624,2291,880,74,3245,9339,-0.3189845474613687,-0.44497004099653104,Rep (McCain),Rep (Romney),3
west virginia,grant,3150,987,0,4137,3775,713,84,4572,11942,-0.5228426395939086,-0.6822638146167558,Rep (McCain),Rep (Romney),3
west virginia,raleigh,17358,10115,0,27473,20375,7651,473,28499,78513,-0.26364066538055547,-0.45400699350603013,Rep (McCain),Rep (Romney),8
west virginia,doddridge,2205,732,0,2937,2108,571,64,2743,8035,-0.501532175689479,-0.5737215378872713,Rep (McCain),Rep (Romney),2
west virginia,calhoun,1345,976,0,2321,1288,801,68,2157,7588,-0.15898319689788884,-0.2331258975586405,Rep (McCain),Rep (Romney),2
west virginia,wood,22670,12446,0,35116,21980,11067,553,33600,86731,-0.2911493336370885,-0.3302266468968439,Rep (McCain),Rep (Romney),8
west virginia,monongalia,15612,16853,0,32465,16672,13664,804,31140,92715,0.03822578161096565,-0.09915611814345991,Dem (Obama),Rep (Romney),9
west virginia,mineral,7546,3717,0,11263,7687,2836,261,10784,27796,-0.33996270975761345,-0.46099021191675377,Rep (McCain),Rep (Romney),6
west virginia,hampshire,5197,2968,0,8165,5514,2294,164,7972,23594,-0.2729944886711574,-0.41239754098360654,Rep (McCain),Rep (Romney),5
west virginia,marshall,7709,5943,0,13652,6208,3395,246,9849,33369,-0.12935833577497802,-0.29292929292929293,Rep (McCain),Rep (Romney),6
west virginia,clay,1748,1417,0,3165,1957,922,110,2989,9572,-0.10458135860979463,-0.3594998263285863,Rep (McCain),Rep (Romney),3
west virginia,randolph,6051,4527,0,10578,6150,3325,252,9727,29233,-0.14407260351673284,-0.29815303430079154,Rep (McCain),Rep (Romney),6
west virginia,taylor,3518,2420,0,5938,3827,1933,127,5887,16732,-0.18491074435836982,-0.32881944444444444,Rep (McCain),Rep (Romney),4
west virginia,logan,6297,4862,0,11159,8186,3461,254,11901,36564,-0.12859575230755443,-0.40568386709023785,Rep (McCain),Rep (Romney),6
west virginia,pocahontas,1993,1538,0,3531,2167,1298,88,3553,8808,-0.12885868026054942,-0.2507936507936508,Rep (McCain),Rep (Romney),2
west virginia,jackson,7066,4821,0,11887,7360,3824,281,11465,29084,-0.1888617817784134,-0.31616595135908443,Rep (McCain),Rep (Romney),6
west virginia,ritchie,2753,989,0,3742,2889,762,98,3749,10514,-0.47140566541956175,-0.5825801150369762,Rep (McCain),Rep (Romney),3
west virginia,mason,5822,4444,0,10266,5706,3738,269,9713,27016,-0.13422949542178064,-0.20838627700127066,Rep (McCain),Rep (Romney),6
west virginia,monroe,3344,1969,0,5313,3571,1441,140,5152,13495,-0.2587991718426501,-0.4249800478850758,Rep (McCain),Rep (Romney),3
west virginia,gilmer,1578,1117,0,2695,1580,830,72,2482,8394,-0.17105751391465676,-0.3112033195020747,Rep (McCain),Rep (Romney),2
west virginia,wyoming,4605,2724,0,7329,5751,1575,170,7496,23993,-0.2566516577977896,-0.5700245700245701,Rep (McCain),Rep (Romney),5
west virginia,tucker,2118,1280,0,3398,2160,876,82,3118,7137,-0.24661565626839319,-0.42292490118577075,Rep (McCain),Rep (Romney),2
west virginia,mercer,13167,7388,0,20555,15406,5416,394,21216,61844,-0.28114813913889564,-0.4797810008644703,Rep (McCain),Rep (Romney),8
west virginia,jefferson,10526,11606,0,22132,11090,10215,471,21776,52033,0.04879812036869691,-0.041070171321286084,Dem (Obama),Rep (Romney),7
west virginia,mingo,4565,3567,0,8132,6163,2421,210,8794,26956,-0.12272503689129366,-0.4359273066169618,Rep (McCain),Rep (Romney),6
west virginia,berkeley,20779,15945,0,36724,21956,14122,726,36804,100910,-0.13163054133536653,-0.2171406397250402,Rep (McCain),Rep (Romney),9
west virginia,braxton,2618,2691,0,5309,2692,1985,79,4756,14558,0.013750235449237145,-0.1511652768868933,Dem (Obama),Rep (Romney),4
west virginia,barbour,3678,2415,0,6093,3804,1761,168,5733,16256,-0.20728705071393402,-0.36711590296495955,Rep (McCain),Rep (Romney),4
west virginia,morgan,4408,2704,0,7112,4508,2361,168,7037,17409,-0.23959505061867267,-0.3125636919493376,Rep (McCain),Rep (Romney),4
west virginia,brooke,4932,4666,0,9598,5014,3984,226,9224,24194,-0.02771410710564701,-0.11446988219604357,Rep (McCain),Rep (Romney),5
west virginia,putnam,15295,9424,0,24719,15926,7198,377,23501,54940,-0.23750960799385087,-0.3774433489015741,Rep (McCain),Rep (Romney),8
west virginia,ohio,10590,8481,0,19071,10577,6623,341,17541,44582,-0.1105867547585339,-0.22988372093023257,Rep (McCain),Rep (Romney),7
west virginia,fayette,7578,7134,0,14712,8304,5368,299,13971,46138,-0.030179445350734094,-0.2147454651843183,Rep (McCain),Rep (Romney),7
west virginia,wayne,8890,6101,0,14991,8673,4915,335,13923,42647,-0.18604496030951906,-0.2765675596114218,Rep (McCain),Rep (Romney),7
west virginia,greenbrier,7347,5561,0,12908,7873,4681,318,12872,35373,-0.13836380539200496,-0.25426158993149595,Rep (McCain),Rep (Romney),6
west virginia,kanawha,40588,40148,0,80736,41037,32190,1224,74451,192770,-0.005449861276258423,-0.12081609242492523,Rep (McCain),Rep (Romney),9
west virginia,cabell,18571,15110,0,33681,17779,13380,585,31744,95526,-0.10275823164395356,-0.1411791135787413,Rep (McCain),Rep (Romney),9
west virginia,harrison,17715,13488,0,31203,15755,9660,533,25948,68490,-0.13546774348620325,-0.2398190045248869,Rep (McCain),Rep (Romney),8
west virginia,wetzel,3318,2919,0,6237,3449,2194,165,5808,16697,-0.06397306397306397,-0.2223994329257487,Rep (McCain),Rep (Romney),4
west virginia,roane,2936,2506,0,5442,2973,1928,126,5027,15116,-0.07901506798970967,-0.21322179147112835,Rep (McCain),Rep (Romney),4
west virginia,preston,7299,4190,0,11489,7841,2916,332,11089,32976,-0.27060666724693183,-0.4578414055963559,Rep (McCain),Rep (Romney),6
west virginia,lincoln,3556,2972,0,6528,4336,2204,207,6747,21879,-0.08946078431372549,-0.3259938837920489,Rep (McCain),Rep (Romney),5
west virginia,upshur,5870,2896,0,8766,5878,2143,174,8195,23984,-0.33926534337211955,-0.46565266176287246,Rep (McCain),Rep (Romney),5
wisconsin,waupaca,12131,12952,0,25083,13989,11565,247,25801,52533,0.032731331977833594,-0.09485794787508806,Dem (Obama),Rep (Romney),8
wisconsin,oconto,8754,9926,0,18680,10691,8810,226,19727,37737,0.06274089935760171,-0.09645659196964258,Dem (Obama),Rep (Romney),7
wisconsin,kewaunee,4711,5902,0,10613,5746,5151,121,11018,20642,0.11222086120795251,-0.054602184087363496,Dem (Obama),Rep (Romney),5
wisconsin,douglas,7833,15827,0,23660,7698,14855,309,22862,43907,0.3378698224852071,0.31734137365317255,Dem (Obama),Dem (Obama),7
wisconsin,door,7112,10142,0,17254,8109,9338,160,17607,27959,0.17561145241683088,0.07044190978391701,Dem (Obama),Dem (Obama),6
wisconsin,waukesha,145089,85248,0,230337,161567,77617,1900,241084,386130,-0.2597976009064979,-0.35098501572011503,Rep (McCain),Rep (Romney),10
wisconsin,kenosha,31237,45615,0,76852,34942,44838,881,80661,164328,0.18708686826627804,0.12404111306091753,Dem (Obama),Dem (Obama),9
wisconsin,vernon,5377,8478,0,13855,5935,8031,249,14215,29460,0.22381811620353662,0.1500787627094372,Dem (Obama),Dem (Obama),6
wisconsin,polk,11282,10876,0,22158,12075,10054,365,22494,44310,-0.018322953335138552,-0.09132812146956483,Rep (McCain),Rep (Romney),7
wisconsin,crawford,2905,5124,0,8029,3064,4622,105,7791,16801,0.2763731473408893,0.20270621909966172,Dem (Obama),Dem (Obama),4
wisconsin,iron,1470,1915,0,3385,1788,1783,49,3620,6075,0.13146233382570163,-0.0014001680201624195,Dem (Obama),Rep (Romney),2
wisconsin,milwaukee,141045,279559,0,420604,158430,328090,4424,490944,937616,0.3293216422097745,0.34872153251664884,Dem (Obama),Dem (Obama),10
wisconsin,shawano,9381,10192,0,19573,11017,8990,215,20222,41842,0.04143462933633066,-0.10131453991103113,Dem (Obama),Rep (Romney),7
wisconsin,richland,3348,5072,0,8420,3575,4964,97,8636,18205,0.20475059382422803,0.16266541749619393,Dem (Obama),Dem (Obama),4
wisconsin,marinette,9705,11124,0,20829,10609,9868,235,20712,42019,0.06812617024341062,-0.036186941446500955,Dem (Obama),Rep (Romney),7
wisconsin,racine,45941,53405,0,99346,49173,52887,877,102937,194736,0.07513135908843839,0.03639035861258084,Dem (Obama),Dem (Obama),9
wisconsin,dunn,9616,13055,0,22671,10210,11303,386,21899,43365,0.15169158837281108,0.05080648909961419,Dem (Obama),Dem (Obama),7
wisconsin,greenlake,5392,3998,0,9390,5779,3790,88,9657,19107,-0.14845580404685835,-0.20785871041906157,Rep (McCain),Rep (Romney),5
wisconsin,grant,9109,14911,0,24020,10255,13574,331,24160,50716,0.24154870940882597,0.13928406563431114,Dem (Obama),Dem (Obama),7
wisconsin,dane,71829,202812,0,274641,83459,215389,3997,302845,477748,0.4769244213354889,0.44146188028696864,Dem (Obama),Dem (Obama),10
wisconsin,columbia,12189,16658,0,28847,13014,17158,288,30460,56350,0.15492078899018963,0.1373458836006894,Dem (Obama),Dem (Obama),8
wisconsin,burnett,4200,4337,0,8537,4541,3981,112,8634,15749,0.016047791964390302,-0.06571227411405774,Dem (Obama),Rep (Romney),4
wisconsin,price,3458,4559,0,8017,3879,3882,109,7870,14452,0.13733316702008233,3.8654812524159255e-4,Dem (Obama),Dem (Obama),4
wisconsin,washburn,4259,4716,0,8975,4692,4435,115,9242,16001,0.050919220055710306,-0.028158211898761915,Dem (Obama),Rep (Romney),4
wisconsin,lacrosse,23698,38514,0,62212,25711,36632,869,63212,112819,0.23815341091750789,0.17517604221805175,Dem (Obama),Dem (Obama),9
wisconsin,wood,16576,21705,0,38281,19685,18546,531,38762,74601,0.1339829158067971,-0.02979257670476838,Dem (Obama),Rep (Romney),8
wisconsin,vilas,7054,6490,0,13544,7735,5931,116,13782,21750,-0.041642055522740695,-0.1320064393385043,Rep (McCain),Rep (Romney),5
wisconsin,forest,1960,2671,0,4631,2172,2421,50,4643,9534,0.1535305549557331,0.05421293272370999,Dem (Obama),Dem (Obama),3
wisconsin,calumet,12720,13296,0,26016,14519,11477,340,26336,47902,0.02214022140221402,-0.11701800276965688,Dem (Obama),Rep (Romney),7
wisconsin,winnebago,37943,48156,0,86099,42073,45410,1331,88814,165032,0.11861926387066052,0.03814455379902381,Dem (Obama),Dem (Obama),9
wisconsin,iowa,3915,8076,0,11991,4302,8099,114,12515,23646,0.34701025769326993,0.3061849850818482,Dem (Obama),Dem (Obama),5
wisconsin,rusk,3253,3855,0,7108,3673,3391,107,7171,14855,0.08469330332020258,-0.039920724801812,Dem (Obama),Rep (Romney),4
wisconsin,menominee,185,1257,0,1442,179,1191,6,1376,4251,0.7434119278779473,0.7386861313868613,Dem (Obama),Dem (Obama),1
wisconsin,eauclaire,20944,33143,0,54087,23218,30618,759,54595,97381,0.22554403091315842,0.13745449141838176,Dem (Obama),Dem (Obama),9
wisconsin,marquette,3625,4051,0,7676,3758,4112,74,7944,15421,0.05549765502866076,0.04498094027954257,Dem (Obama),Dem (Obama),4
wisconsin,trempealeau,4807,8320,0,13127,5703,7601,152,13456,28523,0.26761636322084253,0.1426638604930848,Dem (Obama),Dem (Obama),6
wisconsin,adams,3976,5808,0,9784,4643,5537,83,10263,21044,0.18724448078495504,0.08781925343811395,Dem (Obama),Dem (Obama),5
wisconsin,taylor,4586,4560,0,9146,5597,3761,128,9486,20557,-0.0028427727968510824,-0.19619576832656552,Rep (McCain),Rep (Romney),5
wisconsin,sawyer,4199,4763,0,8962,4436,4482,85,9003,16615,0.06293238116491855,0.0051581071989235255,Dem (Obama),Dem (Obama),4
wisconsin,pepin,1615,2101,0,3716,1793,1875,28,3696,7517,0.13078579117330463,0.022355507088331516,Dem (Obama),Dem (Obama),2
wisconsin,outagamie,39641,50255,0,89896,47294,45565,1378,94237,174457,0.11806976951143544,-0.018619627607447852,Dem (Obama),Rep (Romney),9
wisconsin,jackson,3550,5572,0,9122,3900,5297,93,9290,20284,0.2216619162464372,0.15189735783407632,Dem (Obama),Dem (Obama),5
wisconsin,washington,47725,25713,0,73438,54709,23136,713,78558,130206,-0.2997358315858275,-0.405588027490526,Rep (McCain),Rep (Romney),9
wisconsin,stcroix,22657,20989,0,43646,25475,19874,660,46009,82636,-0.03821656050955414,-0.12350878740435291,Rep (McCain),Rep (Romney),8
wisconsin,langlade,5081,5182,0,10263,5810,4569,103,10482,20218,0.00984117704374939,-0.11956835918681955,Dem (Obama),Rep (Romney),5
wisconsin,buffalo,2946,3979,0,6925,3352,3569,87,7008,13744,0.1491696750902527,0.03135385059962433,Dem (Obama),Dem (Obama),3
wisconsin,monroe,8657,10178,0,18835,9637,9505,247,19389,44053,0.0807539155826918,-0.006895831156618953,Dem (Obama),Rep (Romney),7
wisconsin,bayfield,3316,5978,0,9294,3597,6025,137,9759,15114,0.2864213471056596,0.25233839118686346,Dem (Obama),Dem (Obama),4
wisconsin,barron,10456,12076,0,22532,11413,10883,287,22583,45915,0.0718977454287236,-0.02377108001435235,Dem (Obama),Rep (Romney),7
wisconsin,dodge,23013,19178,0,42191,25190,18745,444,44379,88935,-0.09089616268872508,-0.14669397974280188,Rep (McCain),Rep (Romney),8
wisconsin,jefferson,21095,21448,0,42543,23489,20136,511,44136,82778,0.008297487248195942,-0.0768595988538682,Dem (Obama),Rep (Romney),8
wisconsin,lafayette,2984,4732,0,7716,3313,4534,81,7928,16775,0.22654224987039917,0.1556008665732127,Dem (Obama),Dem (Obama),4
wisconsin,florence,1512,1134,0,2646,1643,952,20,2615,4587,-0.14285714285714285,-0.26628131021194607,Rep (McCain),Rep (Romney),1
wisconsin,manitowoc,19231,22421,0,41652,21581,20382,525,42488,81678,0.07658695860943052,-0.028572790315277746,Dem (Obama),Rep (Romney),8
wisconsin,ashland,2507,5697,0,8204,2816,5387,139,8342,16212,0.38883471477328135,0.3134219188101914,Dem (Obama),Dem (Obama),4
wisconsin,sheboygan,30796,30392,0,61188,34282,28356,634,63272,115328,-0.006602601817349807,-0.09460710750662538,Rep (McCain),Rep (Romney),9
wisconsin,oneida,9627,11905,0,21532,10905,10439,233,21577,36379,0.1057960245216422,-0.021832833583208394,Dem (Obama),Rep (Romney),6
wisconsin,marathon,30339,36363,0,66702,36568,32330,739,69637,132644,0.0903121345686786,-0.06151121948387471,Dem (Obama),Rep (Romney),9
wisconsin,portage,13807,24815,0,38622,16599,22052,535,39186,69437,0.28501890114442546,0.1410830250187576,Dem (Obama),Dem (Obama),8
wisconsin,sauk,11567,18606,0,30173,12829,18718,285,31832,60957,0.23328803897524278,0.18667385171331663,Dem (Obama),Dem (Obama),8
wisconsin,green,6730,11499,0,18229,7848,11196,258,19302,36448,0.26161610620439957,0.17580340264650285,Dem (Obama),Dem (Obama),6
wisconsin,ozaukee,32160,20570,0,52730,35991,19075,499,55565,85945,-0.21979897591503889,-0.3071950023608034,Rep (McCain),Rep (Romney),8
wisconsin,chippewa,13489,16236,0,29725,15371,15211,332,30914,61466,0.09241379310344827,-0.00523183572035838,Dem (Obama),Rep (Romney),8
wisconsin,waushara,5769,5868,0,11637,6558,5330,129,12017,24631,0.008507347254447023,-0.10329744279946164,Dem (Obama),Rep (Romney),5
wisconsin,walworth,25482,24176,0,49658,28962,22512,641,52115,101735,-0.026299891256192354,-0.12530597971791585,Rep (McCain),Rep (Romney),9
wisconsin,juneau,5187,6209,0,11396,5400,6237,144,11781,26733,0.08968058968058969,0.07192575406032482,Dem (Obama),Dem (Obama),6
wisconsin,brown,55827,67241,0,123068,64738,62433,1343,128514,244376,0.09274547404686839,-0.01812520150034206,Dem (Obama),Rep (Romney),10
wisconsin,rock,27356,50515,0,77871,30492,49158,812,80462,159964,0.29740211375223125,0.2343502824858757,Dem (Obama),Dem (Obama),9
wisconsin,lincoln,6510,8419,0,14929,7444,7543,165,15152,29075,0.12787192712170942,0.006605724961633416,Dem (Obama),Dem (Obama),6
wisconsin,pierce,9715,11695,0,21410,10383,10213,324,20920,40530,0.092480149462867825,-0.00825402990872014,Dem (Obama),Rep (Romney),7
wisconsin,fonddulac,28155,23457,0,51612,30329,22356,587,53272,100919,-0.09102534294350151,-0.15133339660244852,Rep (McCain),Rep (Romney),9
wisconsin,clark,6337,7450,0,13787,7394,6173,173,13740,34552,0.08072822223834046,-0.08999778875211911,Dem (Obama),Rep (Romney),6
wyoming,albany,7981,8618,0,16599,7851,7445,756,16052,34926,0.038375805771432014,-0.026542887029288705,Dem (Obama),Rep (Romney),6
wyoming,weston,2618,658,0,3276,2821,422,80,3323,7066,-0.5982905982905983,-0.7397471477027444,Rep (McCain),Rep (Romney),2
wyoming,goshen,3942,1832,0,5774,4178,1458,122,5758,12844,-0.3654312435053689,-0.48261178140525196,Rep (McCain),Rep (Romney),3
wyoming,carbon,4331,2336,0,6667,4152,2109,200,6461,15624,-0.2992350382480876,-0.3263057019645424,Rep (McCain),Rep (Romney),4
wyoming,washakie,2956,1042,0,3998,3013,794,104,3911,8271,-0.47873936968484243,-0.5828736537956396,Rep (McCain),Rep (Romney),2
wyoming,teton,4567,7472,0,12039,4858,6211,287,11356,20802,0.2412991112218623,0.12223326407082843,Dem (Obama),Dem (Obama),5
wyoming,natrona,17573,8144,0,25717,22129,8960,968,32057,73520,-0.36664463195551583,-0.4235903374183795,Rep (McCain),Rep (Romney),8
wyoming,sheridan,10169,4450,0,14619,10267,3618,340,14225,28380,-0.39120322867501195,-0.4788620813827872,Rep (McCain),Rep (Romney),6
wyoming,laramie,24549,16070,0,40619,23247,13807,1003,38057,89221,-0.20874467613678327,-0.25476331840017274,Rep (McCain),Rep (Romney),9
wyoming,crook,2967,612,0,3579,3109,426,122,3657,6761,-0.6580050293378038,-0.7589816124469589,Rep (McCain),Rep (Romney),2
wyoming,bighorn,4043,1108,0,5151,4269,868,125,5262,11448,-0.5697922733449815,-0.6620595678411524,Rep (McCain),Rep (Romney),3
wyoming,niobrara,1017,244,0,1261,1022,200,46,1268,2430,-0.6130055511498811,-0.6726677577741408,Rep (McCain),Rep (Romney),1
wyoming,fremont,11082,6016,0,17098,11072,5333,412,16817,38875,-0.29629196397239443,-0.3498323681804328,Rep (McCain),Rep (Romney),7
wyoming,sublette,3316,936,0,4252,3472,767,98,4337,9322,-0.5597365945437441,-0.6381221986317528,Rep (McCain),Rep (Romney),3
wyoming,platte,2993,1407,0,4400,3136,1223,141,4500,8655,-0.36045454545454547,-0.4388621243404451,Rep (McCain),Rep (Romney),2
wyoming,johnson,3334,908,0,4242,3362,749,106,4217,8307,-0.5719000471475719,-0.63561177329117,Rep (McCain),Rep (Romney),2
wyoming,hotsprings,1834,618,0,2452,1894,523,78,2495,4720,-0.49592169657422513,-0.5672321059164254,Rep (McCain),Rep (Romney),1
wyoming,campbell,13001,2986,0,15987,14952,2163,362,17477,43179,-0.6264464877713142,-0.747239263803681,Rep (McCain),Rep (Romney),7
wyoming,park,10838,3757,0,14595,11234,2927,331,14492,27574,-0.48516615279205205,-0.586611115034249,Rep (McCain),Rep (Romney),6
wyoming,lincoln,6485,1823,0,8308,7144,1287,142,8573,17447,-0.5611458834857969,-0.6946981378246946,Rep (McCain),Rep (Romney),4
wyoming,uinta,5759,2317,0,8076,6613,1628,212,8453,20537,-0.42620108964834075,-0.6049023176798932,Rep (McCain),Rep (Romney),5
wyoming,sweetwater,10360,5762,0,16122,11427,4773,550,16750,42266,-0.2852003473514452,-0.41074074074074074,Rep (McCain),Rep (Romney),7
wyoming,converse,4924,1380,0,6304,5043,1089,155,6287,13404,-0.5621827411167513,-0.6448140900195695,Rep (McCain),Rep (Romney),3
